日	A
昌	AA
晶	AAA
曑	AAAH
曡	AAAM
覸	AABUU
??	AADM	IDS：⿰日⿱日本
焸	AAF
𭧌	AAFU
鷼	AAHAF
暒	AAHM
𣈲	AAHU
??	AAIE	IDS+差量混合表示：⿰日[廄-广]
暥	AAJV
暘	AAMH
??	AAN	IDS：⿰日門
𣋆	AANG
晹	AAPH
暍	AAPV
曝	AATE
𭦂	AAV
暻	AAYF
明	AB
暝	ABAC
曖	ABBE
𣊬	ABBQ
盟	ABBT
焽	ABF
晭	ABGR
鷳	ABHAF
猒	ABIK
曌	ABJCM
暉	ABJJ
暖	ABME
琞	ABMGI
晍	ABMR
勗	ABMS
暩	ABOF
𢜏	ABP
晭	ABQR
昷	ABT
冒	ABU
㬬	ABUG
晛	ABUU
??	AC	IDS：⿰日金
??	ACI	IDS：⿰显戈
暡	ACIM
晜	ACNH
昐	ACSH
杲	AD
??	ADCI	IDS：⿱日松
晽	ADD
鷴	ADHAF
晰	ADHL
时	ADI
??	ADM	IDS：⿱日本
暐	ADMQ
暕	ADWF
鄤	AENL
炅	AF
??	AFBB	IDS：⿰日常
曭	AFBF
暽	AFDQ
晱	AFF
影	AFHHH
顯	AFMBC
晃	AFMU
??	AFNL	IDS：⿰㬎阝
歞	AFNO
??	AFOG	IDS：⿰㬎隹
圼	AG
𣆀	AGB
曀	AGBT
𬀻	AGCG
時	AGDI
曉	AGGU
𬀾	AGLL
𣇌	AGP
暿	AGRR
𣈷	AHAG
??	AHAM	IDS：⿰日⿱白本
晌	AHBR
眉	AHBU
??	AHDS	IDS：⿱日秀
昄	AHE
昸	AHEY
𬊙	AHF
曛	AHGF
晧	AHGR
昴	AHHL
𣆅	AHIO
𣆦	AHJD
剔	AHLN
昕	AHML
暀	AHOG
??	AHOI	IDS：⿰日待
敭	AHOK
暰	AHOO
晷	AHOR
惖	AHP
星	AHQM
昳	AHQO
??	AHQQ	IDS：⿱日𢪙
晧	AHQR
昈	AHS
曒	AHSK
昇	AHT
??	AHTF	IDS：⿱昇火
曍	AHUJ
??	AHV	IDS：⿰易女
昂	AHVL
晲	AHXU
晷	AHYR
晙	AICE
??	AIH	IDS：⿱日戊
晟	AIHS
??	AIIE	IDS+差量混合表示：⿲日[郎-阝]殳
晡	AIJB
既	AIMVU
昹	AINE
𣅿	AIR
即	AISL
昪	AIT
曠	AITC
??	AITF	IDS：⿰日庶
??	AIV	IDS：⿱日戉
早	AJ
暔	AJBJ
昧	AJD
暷	AJII
暑	AJKA
曢	AJKF
𪱄	AJMC
暄	AJMM
𭦤	AJMO
晥	AJMU
晼	AJNU
𬀬	AJR
晏	AJV
旲	AK
暸	AKCF
𪰫	AKJT
晞	AKKB
昦	AKLL
晻	AKLU
晇	AKMS
旯	AKN
𣇍	AKOO
映	ALBK
𣅟	ALBU
堲	ALG
昲	ALLN
晁	ALMO
曊	ALNC
旦	AM
晅	AMAM
曘	AMBB
暊	AMBC
𣌊	AMBE
曤	AMBG
曇	AMBI
晒	AMCW
旴	AMD
𣆏	AMFM
旺	AMG
鴠	AMHAF
毾	AMHQU
戥	AMI
㬐	AMIA
晊	AMIG
??	AMIHS	IDS：⿰星成
旱	AMJ
昊	AMK
昮	AMKS
??	AMMF	IDS：⿰日示
晸	AMMK
曬	AMMP
晤	AMMR
晨	AMMV
昃	AMO
昺	AMOB
鼂	AMRU
昜	AMSH
??	AMT	IDS：⿰日开
曞	AMTB
??	AMUA	IDS：⿰日朁
量	AMWG
曋	AMWJ
昰	AMYM
是	AMYO
門	AN
間	ANA
閶	ANAA
闁	ANAN
闒	ANASM
晚	ANAU
閺	ANAYK
閒	ANB
閿	ANBBE
𨶒	ANBHX
闅	ANBUE
闃	ANBUK
??	ANCR	IDS：⿵門㕣
閲	ANCRU
閑	AND
閉	ANDH
闈	ANDMQ
闌	ANDWF
䦤	ANEEE
閯	ANEFH
闊	ANEHR
焛	ANF
闛	ANFBG
??	ANFBU	IDS：⿵門党
闣	ANFBW
闂	ANFQU
閨	ANGG
闔	ANGIT
??	ANGNO	IDS：⿵門坎
??	ANHA	IDS：⿵門白
䦗	ANHBT
䦭	ANHDA
昅	ANHE
閣	ANHER
𨳝	ANHG
䦚	ANHJR
閽	ANHPA
閐	ANHQU
闑	ANHUD
??	ANHUJ	IDS：⿵門⿱自夲
𨶑	ANHUK
閰	ANHX
𨉖	ANHXH
䦧	ANHXU
閬	ANIAV
䦱	ANIKF
曻	ANIQ
閾	ANIRM
閞	ANIT
闐	ANJBC
闍	ANJKA
𨷛	ANJPI
𫔜	ANJR
閳	ANJWJ
閎	ANKI
閹	ANKLU
𫔚	ANL
闠	ANLMC
閩	ANLMI
閂	ANM
閛	ANMFJ
閏	ANMG
閠	ANMGI
閈	ANMJ
闞	ANMJK
閸	ANMLM
閆	ANMMM
閅	ANMN
閜	ANMNR
開	ANMT
闘	ANMTI
閕	ANMVH
闉	ANMWG
閇	ANMY
𨳕	ANND
閻	ANNHX
閮	ANNKG
闋	ANNOK
𨷺	ANNXU
閃	ANO
閵	ANOG
閥	ANOI
暌	ANOK
𨵦	ANOMN
閤	ANOMR
闟	ANORM
悶	ANP
閟	ANPH
??	ANQO	IDS：⿵門夫
闚	ANQOU
問	ANR
閭	ANRHR
闡	ANRRJ
闆	ANRRR
??	ANRXU	IDS：⿵門黽
聞	ANSJ
闖	ANSQF
闢	ANSRJ
閧	ANTC
闀	ANTCU
関	ANTK
闕	ANTUO
闓	ANUMT
𨶹	ANVFF
關	ANVIT
𨳸	ANW
閫	ANWD
??	ANWHD	IDS：⿵門囷
閘	ANWL
闤	ANWLV
闥	ANYGQ
閌	ANYHN
閍	ANYHS
??	ANYHU	IDS：⿵門⿱亠儿
閗	ANYJ
閔	ANYK
閙	ANYLB
誾	ANYMR
??	ANYRD	IDS：⿵門享
閼	ANYSY
閚	ANYT
闇	ANYTA
閡	ANYVO
𬁔	AOAMJ
韙	AODMQ
尟	AOFH
??	AOG	IDS：⿱日隹
鶗	AOHAF
??	AOHJ	IDS：⿺是千
昤	AOII
昑	AOIN
旿	AOJ
𣋘	AOMA
㫻	AOMB
題	AOMBC
𣈯	AOMN
??	AOMR	IDS：⿰日合
匙	AOP
??	AOR	IDS：⿱⿰日欠口
昨	AOS
𢅨	AOSMB
𦑡	AOSMM
晦	AOWY
㫬	APA
鵾	APHAF
易	APHH
旳	API
昀	APIM
旳	APM
昀	APMM
昆	APP
昫	APR
旽	APU
曷	APVO
晣	AQHL
暳	AQJM
暙	AQKA
晴	AQMB
𧢈	ARBUU
照	ARF
冔	ARMD
暺	ARRJ
曮	ARRK
暇	ARSE
??	ARVP	IDS：⿰日民
??	ASEG	IDS：⿰日堅
煚	ASF
旫	ASH
昭	ASHR
最	ASJE
朂	ASJS
曜	ASMG
𦐇	ASMM
昵	ASP
昛	ASS
暱	ASTR
??	ASTT	IDS：⿰日屏
暯	ATAK
晪	ATBC
曚	ATBO
晎	ATC
曗	ATCD
暴	ATCE
??	ATCG	IDS：⿱日𡋍
謈	ATCR
𣈸	ATGK
𪱋	ATGR
曦	ATGS
??	ATGU	IDS：⿰日羌
??	ATHN	IDS：⿱日荇
𬀲	ATK
暪	ATLB
曣	ATLF
暎	ATLK
暵	ATLO
𣈒	ATMC
曄	ATMJ
𣋭	ATOS
??	ATOV	IDS：⿰日養
??	ATQU	IDS：⿱日⿰羊毛
??	ATT	IDS：⿰日并
𪱋	ATTR
𬁍	ATUI
??	ATXC	IDS：⿰日兼
巴	AU
暨	AUAM
㮣	AUD
㫞	AUE
塈	AUG
毷	AUHQU
??	AUJF	IDS：⿰日崇
勖	AUKS
暟	AUMT
郿	AUNL
鱀	AUNWF
??	AUP	IDS：⿱⿰日㔾心
岊	AUU
艮	AV
鶡	AVHAF
曏	AVHL
毼	AVHQU
𣇓	AVML
㫽	AVNE
歇	AVNO
??	AWK	IDS：⿰日因
曙	AWLA
曼	AWLE
曎	AWLJ
??	AWTJ	IDS：⿰日畢
晫	AYAJ
曨	AYBP
昗	AYC
??	AYDI	IDS：⿰日孰
暾	AYDK
昉	AYHS
旻	AYK
??	AYLB	IDS：⿰日市
曃	AYLE
晬	AYOJ
??	AYPM	IDS：⿰日虛
暠	AYRB
景	AYRF
曩	AYRV
暆	AYSD
昱	AYT
暗	AYTA
曈	AYTG
暲	AYTJ
𪱍	AYTP
??	AYTR	IDS：⿰日咅
??	AYTU	IDS：⿰日竟
𣌪	AYV
昡	AYVI
𣋠	AYX
月	B
腽	BABT
腥	BAHM
胆	BAM
腸	BAMH
肥	BAU
𦚣	BAV
𫆳	BAWE
冥	BAYC
朋	BB
骨	BBB
朤	BBBB
腡	BBBR
覶	BBBUU
骽	BBBV
骳	BBDHE
脟	BBDI
受	BBE
髐	BBGGU
??	BBGWC	IDS：⿰骨賣
鶻	BBHAF
骼	BBHER
鵬	BBHF
骰	BBHNE
骶	BBHPM
髀	BBHWJ
髆	BBIBI
髍	BBIDD
髍	BBIJC
髂	BBJHR
髕	BBJMC
骷	BBJR
髖	BBJTI
骻	BBKMS
骩	BBKN
骫	BBKNI
髏	BBLLV
剮	BBLN
册	BBM
顝	BBMBC
骭	BBMJ
骾	BBMLK
胴	BBMR
脬	BBND
??	BBNF	IDS：⿳爫冖魚
䯕	BBNKG
舜	BBNQ
骱	BBOLL
𦞼	BBOU
愛	BBPE
??	BBQJM	IDS：⿰骨彗
咼	BBR
髒	BBTMT
髊	BBTQM
骿	BBTT
體	BBTWT
亂	BBU
臞	BBUG
鼏	BBUL
覓	BBUU
脮	BBV
髁	BBWD
髑	BBWLI
??	BBWLO	IDS：⿰骨眾
髈	BBYBS
骹	BBYCK
骯	BBYHN
髓	BBYKB
骴	BBYMP
髇	BBYRB
辭	BBYTJ
骸	BBYVO
賵	BCABU
賜	BCAPH
??	BCAPP	IDS：⿰貝昆
贔	BCBCC
賝	BCBCD
賙	BCBGR
賱	BCBJJ
??	BCBND	IDS：⿰貝孚
賙	BCBQR
賏	BCBUC
覭	BCBUU
??	BCCMS	IDS：⿰貝兮
𬥏	BCCSH
贈	BCCWA
罙	BCD
財	BCDH
??	BCDW	IDS：⿰貝東
??	BCDWF	IDS：⿰貝柬
贘	BCFBC
𧸍	BCFDQ
賧	BCFF
䞉	BCFQC
??	BCFQE	IDS：⿰貝𣳾
??	BCGI	IDS：⿰貝去
贖	BCGWC
鵙	BCHAF
賉	BCHBT
販	BCHE
賂	BCHER
𬥘	BCHGR
貶	BCHIO
𧵳	BCHJR
??	BCHML	IDS：⿰冥斤
貾	BCHPM
貹	BCHQM
㲘	BCHQU
賻	BCIBI
賐	BCICE
賍	BCIG
賤	BCII
贂	BCIIH
賊	BCIJ
賕	BCIJE
贆	BCIKK
䐥	BCIM
贓	BCIMS
貽	BCIR
肸	BCJ
賳	BCJIR
賭	BCJKA
賩	BCJMF
貯	BCJMN
賄	BCKB
??	BCKKG	IDS+差量混合表示：⿱㓁[𡙔-土]
賗	BCLL
贃	BCLLP
贐	BCLMT
則	BCLN
𫎏	BCMD
??	BCMGI	IDS：⿰貝玉
罕	BCMJ
𧵳	BCMJR
貦	BCMMU
賑	BCMMV
賦	BCMPM
甖	BCMVN
贉	BCMWJ
贍	BCNCR
鄍	BCNL
??	BCOII	IDS：⿰貝令
賶	BCOIR
罌	BCOJU
敗	BCOK
賖	BCOMD
賒	BCOMF
貤	BCPD
賰	BCQKA
冏	BCR
貺	BCRHU
腳	BCRL
脱	BCRU
鼆	BCRXU
朌	BCSH
𧵓	BCSHR
賬	BCSMV
賟	BCTBC
𧸢	BCTCD
贌	BCTCO
賹	BCTCT
𧸡	BCTGI
購	BCTTB
賺	BCTXC
??	BCUUK	IDS：⿰貝𣁋
嬰	BCV
𧸏	BCWLC
貥	BCYHN
𫎒	BCYHS
譻	BCYMR
賥	BCYOJ
貼	BCYR
賠	BCYTR
賅	BCYVO
采	BD
䏢	BDHE
彩	BDHHH
肘	BDI
郛	BDNL
膝	BDOE
乳	BDU
腏	BEEE
鶢	BEHAF
炙	BF
膛	BFBG
膌	BFCB
冞	BFD
𣎝	BFDF
膦	BFDQ
朥	BFFS
縣	BFHVF
爒	BFKCF
胱	BFMU
鄬	BFNL
懸	BFP
胖	BFQ
賸	BFQC
滕	BFQE
騰	BFQF
塍	BFQG
螣	BFQI
??	BFQQ	IDS+差量混合表示：⿸[勝-力][奉-𡗗]
謄	BFQR
勝	BFQS
腃	BFQU
媵	BFQV
乿	BFU
肚	BG
膮	BGGU
鸜	BGHAF
氍	BGHQU
胠	BGI
脚	BGIL
䏯	BGP
周	BGR
臌	BGTE
膨	BGTH
胉	BHA
腺	BHAE
䐿	BHBK
𧳆	BHBMR
貜	BHBUE
貕	BHBVK
豺	BHDH
脷	BHDN
𧳟	BHDOO
腇	BHDV
膰	BHDW
胮	BHEQ
胳	BHER
臐	BHGF
貃	BHHA
貌	BHHAU
貉	BHHER
肜	BHHH
??	BHHJ	IDS：⿰豸千
䝘	BHHNE
脈	BHHV
貏	BHHWJ
貔	BHHWP
貎	BHHXU
𧳓	BHIAV
貁	BHJC
腶	BHJE
腫	BHJG
腄	BHJM
腯	BHJU
𬁷	BHK
𧲱	BHLBK
貗	BHLLV
貄	BHLQ
𧲹	BHLW
貊	BHMA
貆	BHMAM
䫉	BHMBC
𧳏	BHMFR
豻	BHMJ
肵	BHML
𧲨	BHMT
肌	BHN
股	BHNE
爲	BHNF
豽	BHOB
貅	BHOD
貐	BHOMN
胻	BHON
豹	BHPI
胝	BHPM
䝟	BHQHK
𬚾	BHQI
胜	BHQM
胅	BHQO
貚	BHRRJ
貑	BHRSE
貂	BHSHR
貙	BHSRR
貘	BHTAK
??	BHTCT
??	BHTRG
貓	BHTW
臢	BHUC
貒	BHUMB
貀	BHUU
胍	BHVO
貍	BHWG
脾	BHWJ
膍	BHWP
舀	BHX
??	BHXE
腴	BHXO
??	BHXU
??	BHYPU
??	BI
??	BIAV
膊	BIBI
朘	BICE
??	BIIL
脯	BIJB
脙	BIJE
??	BIK
胈	BIKK
??	BIKU
??	BIMBC
脈	BINE
腑	BIOI
膩	BIPC
臕	BIPF
胎	BIR
??	BIXP
虢	BIYPU
肺	BJB
脖	BJBD
腩	BJBJ
膣	BJCG
腔	BJCM
皸	BJDHE
肢	BJE
鶤	BJHAF
膞	BJII
??	BJKA
蠈	BJLMI
顐	BJMBC
臏	BJMC
??	BJMO
脘	BJMU
鄆	BJNL
腕	BJNU
??	BJON
膹	BJTC
臗	BJTI
胺	BJV
軍	BJWJ
膫	BKCF
谿	BKCOR
然	BKF
雞	BKHAF
肱	BKI
网	BKK
??	BKKB
??	BKKI
腌	BKLU
??	BKMF
胯	BKMS
胰	BKN
肒	BKNI
郹	BKNL
雞	BKOG
脥	BKOO
肋	BKS
脅	BKSS
胦	BLBK
??	BLLL
胇	BLLN
膢	BLLV
朓	BLMO
腓	BLMY
刖	BLN
??	BLPC
胂	BLWL
胏	BLXH
且	BM
??	BMA
臑	BMBB
??	BMBC
臛	BMBG
??	BMBI
??	BMBK
胹	BMBL
??	BMCW
??	BMF
??	BMFJ
胚	BMFM
??	BMFR
??	BMGN
??	BMHML
胵	BMIG
肝	BMJ
爰	BMKE
助	BMKS
刪	BMLN
具	BMMC
冢	BMMO
??	BMMP
朊	BMMU
脤	BMMV
??	BMNR
??	BMOB
雎	BMOG
同	BMR
膈	BMRB
脰	BMRT
腷	BMRW
豚	BMSO
冠	BMUI
脛	BMVM
膘	BMWF
靦	BMWL
腰	BMWV
??	BMYM
肊	BN
冤	BNAI
脆	BNAU
膽	BNCR
孚	BND
膙	BNII
脡	BNKG
??	BNKL
腱	BNKQ
??	BNKU
蠫	BNLII
脆	BNMU
??	BNOB
腹	BOAE
??	BOAH
肭	BOB
朒	BOBO
胕	BODI
脽	BOG
膲	BOGF
臇	BOGS
胗	BOHH
??	BOII
肣	BOIN
腍	BOIP
膾	BOMA
??	BOMB
祭	BOMMF
腧	BOMN
臉	BOMO
豋	BOMRT
??	BOMV
肐	BON
脞	BOOG
胣	BOPD
胙	BOS
膴	BOTF
脢	BOWY
??	BOYMR
脂	BPA
??	BPD
??	BPHH
吻	BPHR
??	BPP
朐	BPR
胞	BPRU
??	BPT
肫	BPU
胸	BPUK
用	BQ
??	BQHAF
??	BQJ
??	BQKA
??	BQKE
腠	BQKK
??	BQKP
??	BQKQ
膆	BQMF
周	BQR
甩	BQU
??	BR
??	BRB
胑	BRC
鵰	BRHAF
脭	BRHG
彫	BRHHH
戙	BRI
??	BRMG
??	BRNL
雕	BROG
臊	BRRD
齶	BRRS
??	BRSE
翢	BRSMM
??	BRYO
爭	BSD
??	BSEC
鵩	BSEF
豸	BSHH
肕	BSHI
??	BSHR
??	BSHU
腒	BSJR
服	BSLE
腛	BSMG
膠	BSMH
??	BSMJ
脹	BSMV
??	BSRR
凸	BSS
皿	BT
腊	BTA
冪	BTAB
膜	BTAK
??	BTAV
腆	BTBC
朦	BTBO
??	BTCP
膉	BTCT
膳	BTGR
臟	BTIS
朕	BTK
臙	BTLF
??	BTLJ
朠	BTLK
刪	BTLN
頯	BTMBC
??	BTMC
腜	BTMD
??	BTMJ
臒	BTOE
胼	BTT
??	BTTC
??	BTTM
膳	BTTR
岡	BTU
??	BTVI
??	BTW
膿	BTWV
賺	BTXC
膵	BTYJ
罔	BTYV
目	BU
??	BUAHU
睅	BUAMJ
睼	BUAMO
瞷	BUANA
??	BUANB
??	BUANG
矙	BUANK
眼	BUAV
瞑	BUBAC
曖	BUBBE
瞬	BUBBQ
睬	BUBD
睭	BUBGR
??	BUBJJ
??	BUBNQ
??	BUBQR
睜	BUBSD
瞁	BUBUK
睍	BUBUU
??	BUBV
貝	BUC
朡	BUCE
瞈	BUCIM
盻	BUCMS
睇	BUCNH
??	BUCRO
盼	BUCSH
??	BUDHL
??	BUDMQ
睞	BUDOO
??	BUF
睄	BUFB
矘	BUFBF
瞠	BUFBG
眯	BUFD
瞵	BUFDQ
睒	BUFF
眇	BUFH
??	BUFMU
??	BUFQ
??	BUFQG
睠	BUFQU
睖	BUGCE
睦	BUGCG
眭	BUGG
瞌	BUGIT
鷂	BUHAF
??	BUHDE
瞅	BUHDF
??	BUHDN
眅	BUHE
??	BUHG
矄	BUHGF
眽	BUHHV
眨	BUHIO
??	BUHJD
睡	BUHJM
瞃	BUHJU
??	BUHKB
盺	BUHML
颻	BUHNI
覹	BUHOK
瞛	BUHOO
睧	BUHPA
??	BUHPM
睋	BUHQI
眣	BUHQO
眊	BUHQU
睙	BUHSK
見	BUHU
??	BUHUJ
矏	BUHUS
繇	BUHVF
??	BUHVP
睥	BUHWJ
瞍	BUHXE
睨	BUHXU
??	BUICE
眸	BUIHQ
狊	BUIK
??	BUILR
??	BUINE
眙	BUIR
矌	BUITC
眓	BUIV
瞋	BUJBC
??	BUJCM
眛	BUJD
睹	BUJKA
??	BUJKF
??	BUJKP
睫	BUJLO
矉	BUJMC
??	BUJMM
眝	BUJMN
??	BUJMO
睆	BUJMU
睕	BUJNU
瞎	BUJQR
瞭	BUKCF
睎	BUKKB
眱	BUKN
??	BUKSS
??	BULBK
眈	BULBU
瞣	BULLP
瞜	BULLV
瞶	BULMC
蜰	BULMI
眺	BULMO
剛	BULN
眒	BULWL
矐	BUMBG
盱	BUMD
??	BUMFM
睚	BUMGG
??	BUMIG
盰	BUMJ
瞰	BUMJK
??	BUMLK
眄	BUMLS
??	BUMMF
眃	BUMMI
盯	BUMN
??	BUMOB
瞟	BUMWF
瞫	BUMWJ
眐	BUMYM
睌	BUNAU
矎	BUNBE
瞻	BUNCR
瞲	BUNHB
眵	BUNIN
眳	BUNIR
睽	BUNOK
瞪	BUNOT
瞿	BUOG
矍	BUOGE
瞧	BUOGF
眕	BUOHH
??	BUOIN
瞺	BUOMA
睔	BUOMB
??	BUOMG
睮	BUOMN
瞼	BUOMO
盵	BUON
??	BUONK
??	BUOQ
瞴	BUOTF
??	BUOYM
眴	BUPA
盷	BUPIM
??	BUPMM
??	BUPP
盹	BUPU
??	BUQJ
睛	BUQMB
??	BUQMV
瞡	BUQOU
睊	BURB
矂	BURRD
??	BURSE
眠	BURVP
矚	BUSEI
眧	BUSHR
眲	BUSJ
??	BUSJR
眶	BUSMG
??	BUSMI
??	BUSP
??	BUSRR
瞙	BUTAK
??	BUTBC
矇	BUTBO
瞨	BUTCO
??	BUTCP
眹	BUTK
瞞	BUTLB
瞱	BUTMJ
??	BUTOE
??	BUTPD
眻	BUTQ
矔	BUTRG
瞄	BUTW
朏	BUU
??	BUUMG
??	BUUMT
??	BUUUK
??	BUV
矊	BUVFB
眑	BUVIS
鼎	BUVML
睩	BUVNE
睏	BUWD
??	BUWML
??	BUWT
矓	BUYBP
??	BUYDK
瞇	BUYFD
??	BUYK
??	BUYMP
睟	BUYOJ
??	BUYPT
瞳	BUYTG
瞕	BUYTJ
瞝	BUYUB
盳	BUYV
眩	BUYVI
妥	BV
墾	BVG
鸚	BVHAF
膷	BVHL
奚	BVIK
郻	BVNL
腞	BVNO
懇	BVP
??	BVVB
臘	BVVV
腦	BVVW
??	BWD
??	BWG
膕	BWIM
??	BWJR
胭	BWK
胛	BWL
腢	BWLB
爵	BWLI
腲	BWMV
膃	BWOT
腮	BWP
??	BWYI
丹	BY
腿	BYAV
膼	BYBB
朧	BYBP
膀	BYBS
??	BYCK
??	BYDK
鴅	BYHAF
彤	BYHHH
肮	BYHN
膇	BYHR
肪	BYHS
膱	BYIA
膟	BYIJ
??	BYIN
??	BYIU
??	BYJ
??	BYK
肺	BYLB
刐	BYLN
脺	BYOJ
腋	BYOK
臄	BYPO
臚	BYPT
脝	BYRN
??	BYRU
腤	BYTA
朣	BYTG
雘	BYTOE
臆	BYTP
臃	BYVG
胘	BYVI
胲	BYVO
膻	BYWM
臍	BYX
金	C
鈤	CA
錩	CAA
??	CAB
??	CABT
鎤	CAFU
??	CAHM
??	CAHT
??	CAHU
鉭	CAM
??	CAMG
鍚	CAMH
??	CAMI
銲	CAMJ
鍉	CAMO
甑	CAMVN
鍆	CAN
鐧	CANA
鄫	CANL
??	CANT
鑭	CANW
??	CAOP
錫	CAPH
錕	CAPP
鍻	CAPV
鎉	CASM
鑤	CATE
鈀	CAU
銀	CAV
鏝	CAWE
??	CAYF
??	CAYT
鈅	CB
錋	CBB
鑀	CBBE
??	CBBM
鍋	CBBR
鍘	CBCN
鋝	CBDI
錭	CBGR
鍕	CBJJ
鉏	CBM
??	CBMC
鍰	CBME
銅	CBMR
鋤	CBMS
??	CBND
??	CBOF
??	CBOU
??	CBQ
??	CBQR
錚	CBSD
??	CBT
鋼	CBTU
??	CBTV
鉬	CBU
鋇	CBUC
钁	CBUE
??	CBUG
??	CBUL
??	CBUM
鋧	CBUU
??	CBV
??	CBY
??	CC
鑫	CCC
鈆	CCI
??	CCLN
銻	CCNH
鋊	CCOR
鉛	CCR
銳	CCRU
鈖	CCSH
??	CCWA
??	CD
??	CDA
??	CDBU
??	CDCI
??	CDD
??	CDDD
??	CDDQ
??	CDF
釮	CDH
鈹	CDHE
鈌	CDK
鋉	CDL
缽	CDM
鍏	CDMQ
錸	CDOO
??	CDR
鍊	CDWF
??	CE
錔	CEA
鐋	CEAH
??	CEBR
鎟	CEED
錣	CEEE
??	CEGI
鎃	CEHV
釵	CEI
鈥	CF
銷	CFB
??	CFBB
鎖	CFBC
鏿	CFBD
钂	CFBF
鏜	CFBG
??	CFBQ
鋿	CFBR
鎲	CFBU
鐺	CFBW
銤	CFD
鏻	CFDQ
錟	CFF
鑅	CFFD
鐒	CFFS
鈔	CFH
??	CFHS
??	CFK
銧	CFMU
??	CFOG
鉡	CFQ
??	CFQE
??	CFQH
錈	CFQU
釷	CG
??	CGAH
錂	CGCE
錴	CGCG
銈	CGG
??	CGGG
鐃	CGGU
鉣	CGI
鎑	CGIT
鑄	CGNI
??	CGOG
??	CGOW
鋕	CGP
銡	CGR
??	CGRR
鎱	CGRV
??	CGSK
??	CGWC
鉑	CHA
錦	CHAB
??	CHAE
??	CHAF
鍠	CHAG
??	CHAH
??	CHAI
??	CHBD
??	CHBK
??	CHBR
??	CHCQ
鉌	CHD
??	CHDA
鏼	CHDB
鍬	CHDF
鋓	CHDN
??	CHDP
銹	CHDS
??	CHDU
??	CHDV
鐇	CHDW
鈑	CHE
鋒	CHEJ
??	CHEQ
鉻	CHER
??	CHET
鉖	CHEY
??	CHFS
??	CHG
??	CHGF
??	CHGI
鋯	CHGR
銑	CHGU
鵜	CHHAF
鑗	CHHE
釤	CHHH
鉚	CHHL
??	CHHV
鎦	CHHW
??	CHI
??	CHIR
??	CHJ
銖	CHJD
鍛	CHJE
鍾	CHJG
錘	CHJM
銛	CHJR
鍎	CHJU
鍤	CHJX
??	CHK
??	CHKB
??	CHLB
鑕	CHLC
剃	CHLN
??	CHLO
頒	CHMBC
釿	CHML
銗	CHMR
??	CHN
??	CHND
??	CHNE
??	CHNI
邠	CHNL
鉛	CHNR
攽	CHOK
鏦	CHOO
??	CHP
錉	CHPA
鋨	CHQI
鉎	CHQM
鐵	CHQO
??	CHQR
??	CHQU
鎢	CHRF
??	CHST
鑽	CHUC
鎳	CHUD
鎴	CHUP
??	CHVF
鈲	CHVO
錍	CHWJ
??	CHWP
??	CHXC
鎪	CHXE
??	CHXG
銵	CHXH
??	CHXS
公	CI
鋃	CIAV
??	CIBF
鎛	CIBI
??	CIBP
??	CICB
鋑	CICE
??	CID
??	CIGI
??	CIH
鏚	CIHF
??	CIHM
鉾	CIHQ
鍼	CIHR
鋮	CIHS
鈗	CIHU
錢	CII
鏒	CIIH
鎯	CIIL
??	CIJ
鋪	CIJB
鉥	CIJC
銶	CIJE
??	CIJJ
??	CIK
??	CIKF
??	CIKH
鈸	CIKK
鏞	CILB
鏮	CILE
銂	CILL
??	CILO
鎕	CILR
頌	CIMBC
瓮	CIMN
銢	CINE
??	CING
??	CIP
鑣	CIPF
鉽	CIPM
鋱	CIPP
鈶	CIR
??	CIRM
??	CIRP
翁	CISM
??	CIT
礦	CITC
鍍	CITE
鏣	CITF
鉞	CIV
??	CIXE
鏕	CIXP
針	CJ
??	CJB
鎮	CJBC
鋍	CJBD
鎍	CJBF
??	CJBJ
??	CJBM
??	CJCM
鎔	CJCR
??	CJD
??	CJDI
??	CJE
??	CJHR
鐵	CJIG
鏄	CJII
鏸	CJIP
??	CJJL
??	CJJN
鍺	CJKA
??	CJKF
鋐	CJKI
銠	CJKP
??	CJKR
銬	CJKS
鑌	CJMC
錝	CJMF
鍹	CJMM
錠	CJMO
鋎	CJMU
鋺	CJNU
??	CJOA
鉈	CJP
鑏	CJPN
鈷	CJR
??	CJRB
錧	CJRR
??	CJRU
鐼	CJTC
??	CJTI
鑳	CJTO
銨	CJV
??	CJWC
??	CJYJ
父	CK
爸	CKAU
銪	CKB
鎩	CKCE
鐐	CKCF
鎩	CKDE
??	CKE
鍷	CKGG
斧	CKHML
鈜	CKI
錛	CKJT
??	CKKK
鈽	CKLB
銌	CKLD
??	CKM
錼	CKMF
釜	CKMGC
錡	CKMR
銙	CKMS
銕	CKN
??	CKNI
爹	CKNIN
鋏	CKOO
??	CKPB
??	CKR
爺	CKSJL
??	CKSR
??	CKTCT
丫	CL
??	CLA
鉠	CLBK
鈂	CLBU
??	CLL
釧	CLLL
鏤	CLLV
鐀	CLMC
銚	CLMO
??	CLMP
釗	CLN
鐨	CLNC
??	CLP
??	CLU
鈾	CLW
??	CLWL
鏽	CLX
釭	CM
銆	CMA
鑐	CMBB
顉	CMBC
鐳	CMBW
??	CMCA
??	CMCW
釪	CMD
??	CME
??	CMF
鑈	CMFB
鋄	CMFE
??	CMFJ
??	CMFM
??	CMG
??	CMGG
鈺	CMGI
??	CMGN
鑩	CMGR
鶲	CMHAF
??	CMHF
??	CMIA
銍	CMIG
釬	CMJ
??	CMJJ
鉶	CMJN
??	CMJR
??	CMJS
??	CMJX
??	CMLB
??	CMLK
錏	CMLM
??	CMMC
??	CMMP
鋙	CMMR
釫	CMMS
??	CMMU
鋠	CMMV
釘	CMN
鈳	CMNR
??	CMOB
??	CMOO
??	CMOR
憌	CMP
??	CMPC
??	CMPM
鉐	CMR
鎘	CMRB
鋀	CMRT
??	CMRW
??	CMSU
鈃	CMT
鉶	CMTN
鐕	CMUA
??	CMUE
??	CMVH
鎒	CMVI
鋞	CMVM
??	CMVN
兮	CMVS
??	CMWC
??	CMWD
鏢	CMWF
鐔	CMWJ
鉦	CMYM
鈣	CMYS
釔	CN
鐌	CNAO
??	CNAU
??	CNBE
??	CNBG
釨	CND
錳	CNDT
鈕	CNG
鐍	CNHB
鍒	CNHD
鈒	CNHE
釢	CNHS
錎	CNHX
釸	CNI
鏹	CNII
??	CNIL
鉹	CNIN
銘	CNIR
鋌	CNKG
鋋	CNKM
鍵	CNKQ
鈏	CNL
弟	CNLH
錒	CNLR
釕	CNN
欽	CNO
鏺	CNOE
??	CNOK
鐙	CNOT
??	CNQD
鑱	CNRI
??	CNST
??	CNWA
鍑	COAE
鈉	COB
銝	COD
??	CODI
錐	COG
鏶	COGD
??	COGE
鐎	COGF
鎨	COGJ
鐫	COGS
銋	COHG
??	COHH
??	COHL
鈴	COII
鑯	COIM
鈐	COIN
??	COIP
鎗	COIR
??	COLB
鎀	COLH
螸	COLMI
鑰	COMB
??	COMC
銓	COMG
??	COMN
鐱	COMO
鉿	COMR
??	COMV
釳	CON
鎎	COND
鍭	CONK
銼	COOG
慾	COP
谷	COR
??	CORD
??	CORQ
鋂	COWY
??	CP
??	CPA
??	CPD
鉍	CPH
釣	CPI
鈞	CPIM
??	CPMC
鈞	CPMM
鋾	CPOU
鈚	CPP
鍇	CPPA
鉤	CPR
鉋	CPRU
??	CPT
鍱	CPTD
鈍	CPU
鍧	CPYR
銇	CQD
鍥	CQHK
??	CQJ
鏏	CQJM
??	CQKE
錆	CQMB
??	CQMF
錶	CQMV
鈇	CQO
釦	CR
鋗	CRB
??	CRBC
??	CRBVK
??	CRGWC
鵒	CRHAF
??	CRHG
鋁	CRHR
兌	CRHU
谾	CRJCM
谹	CRKI
??	CRLB
??	CRMG
豃	CRMJK
??	CRMR
??	CRMVH
郤	CRNL
欲	CRNO
谻	CRNQ
??	CROG
谽	CROIR
懖	CRP
??	CRPA
鐰	CRRD
??	CRRJ
??	CRRR
鍔	CRRS
鍜	CRSE
??	CRSJ
卻	CRSL
豂	CRSMH
谼	CRTC
鐉	CRUC
鋘	CRVK
鈱	CRVP
豅	CRYBP
??	CRYO
??	CSEC
鏗	CSEG
钃	CSEI
分	CSH
貧	CSHC
??	CSHE
炃	CSHF
坌	CSHG
??	CSHI
忿	CSHP
??	CSHQ
鉊	CSHR
盆	CSHT
岔	CSHU
??	CSHX
鑑	CSIT
鉺	CSJ
鋷	CSJE
鑷	CSJJ
鋸	CSJR
??	CSJU
??	CSKR
鉔	CSLB
??	CSLC
??	CSMA
鋟	CSME
??	CSMG
鏐	CSMH
??	CSMI
??	CSMM
鉰	CSMR
鑑	CSMT
鋹	CSMV
鈮	CSP
鎷	CSQF
??	CSR
??	CSRG
鏂	CSRR
鉅	CSS
鋦	CSSR
??	CSU
錯	CTA
鏌	CTAK
??	CTAW
錪	CTBC
鏾	CTBK
??	CTBN
??	CTC
鐠	CTCA
??	CTCD
??	CTCG
??	CTCH
鏷	CTCO
鎰	CTCT
鑮	CTEI
??	CTGI
鎂	CTGK
??	CTGO
??	CTGR
鑉	CTGT
錓	CTGU
??	CTGV
鑶	CTIS
??	CTKR
??	CTLB
??	CTLC
??	CTLK
??	CTLM
??	CTLX
鉗	CTM
鐠	CTMA
錤	CTMC
??	CTMD
鏵	CTMJ
鍖	CTMV
??	CTOD
鑊	CTOE
??	CTOF
錵	CTOP
鎝	CTOR
鐷	CTPD
??	CTPO
鎈	CTQM
鑵	CTRG
??	CTRS
鍣	CTSR
鉼	CTT
??	CTTR
鎙	CTUB
??	CTUI
??	CTVG
鎡	CTVI
??	CTVP
錨	CTW
??	CTWA
??	CTWB
鐏	CTWI
??	CTWT
鎌	CTXC
鑝	CTYJ
??	CTYS
鋩	CTYV
釓	CU
??	CUAP
鍐	CUCE
??	CUHJ
毤	CUHQU
??	CUJT
??	CUMB
??	CUMF
錌	CUMJ
??	CUMR
鎧	CUMT
鑴	CUOB
鏙	CUOG
敓	CUOK
??	CUU
釹	CV
??	CVD
??	CVFD
??	CVFI
鐑	CVFR
鑠	CVID
??	CVIF
鐖	CVII
鉯	CVIO
鏘	CVMI
??	CVND
錄	CVNE
??	CVP
銣	CVR
??	CVVC
??	CVVD
鑞	CVVV
錙	CVVW
鈿	CW
曾	CWA
錁	CWD
鋰	CWG
??	CWJC
錮	CWJR
銦	CWK
鉀	CWL
鑼	CWLG
鐲	CWLI
鐸	CWLJ
??	CWLM
鐶	CWLV
鍡	CWMV
??	CWOT
鍶	CWP
鏎	CWTJ
鏍	CWVF
鑸	CWWG
鉧	CWYI
釙	CY
鍗	CYBB
鍞	CYBC
钀	CYBK
鑨	CYBP
鎊	CYBS
??	CYBU
鏑	CYCB
鉸	CYCK
??	CYDI
鐓	CYDK
??	CYDU
鈙	CYE
??	CYED
鉒	CYG
鐽	CYGQ
??	CYHJ
鏟	CYHM
鈧	CYHN
鎚	CYHR
鈁	CYHS
??	CYHU
銥	CYHV
錥	CYIB
??	CYIU
鈄	CYJ
鏈	CYJJ
??	CYK
??	CYKH
鏟	CYKM
鈰	CYLB
??	CYLH
??	CYLM
錹	CYMB
鐬	CYMH
鉲	CYMY
??	CYOJ
鏬	CYPD
??	CYPN
鐻	CYPO
鑢	CYPP
??	CYPQ
鐪	CYPS
鑪	CYPT
??	CYPU
鉆	CYR
鎬	CYRB
錞	CYRD
??	CYRF
??	CYRL
??	CYRN
??	CYRU
鑲	CYRV
??	CYSD
鏃	CYSK
鏇	CYSO
??	CYT
??	CYTA
鐘	CYTG
??	CYTJ
??	CYTK
鐩	CYTO
鐿	CYTP
??	CYTR
鏡	CYTU
??	CYVB
鉉	CYVI
??	CYVQ
鏀	CYWI
鑇	CYX
木	D
杳	DA
??	DAA
??	DABT
榥	DAFU
榯	DAGI
??	DAHM
楣	DAHU
楖	DAIL
概	DAIU
查	DAM
??	DAMG
楊	DAMH
桿	DAMJ
??	DAN
??	DANA
??	DANB
橍	DANG
櫚	DANR
欄	DANW
棍	DAPP
楬	DAPV
??	DASE
榻	DASM
杷	DAU
根	DAV
槾	DAWE
??	DAYF
朿	DB
榠	DBAC
棚	DBB
榾	DBBB
柵	DBBM
??	DBBQ
??	DBBR
棎	DBCD
櫻	DBCV
棌	DBD
棘	DBDB
椆	DBGR
槄	DBHX
楎	DBJJ
橪	DBKF
??	DBKS
刺	DBLN
柤	DBM
椇	DBMC
楥	DBME
??	DBMM
桐	DBMR
桴	DBND
僰	DBO
榣	DBOU
??	DBQR
棦	DBSD
棴	DBSE
柵	DBT
棡	DBTU
??	DBTV
相	DBU
梖	DBUC
??	DBUE
??	DBUF
欋	DBUG
??	DBUL
??	DBUU
桵	DBV
榽	DBVK
??	DBWI
??	DBY
朳	DC
檭	DCAV
??	DCHB
椕	DCHD
??	DCHK
松	DCI
棇	DCIP
枍	DCMS
梯	DCNH
??	DCR
梲	DCRU
枌	DCSH
??	DCST
橧	DCWA
林	DD
楂	DDAM
栜	DDB
??	DDBCQ
??	DDBHN
??	DDBTI
??	DDBU
鬱	DDBUH
棼	DDCSH
森	DDD
??	DDDL
??	DDDN
檚	DDDO
櫇	DDEC
焚	DDF
埜	DDG
材	DDH
柀	DDHE
彬	DDHH
梵	DDHNI
村	DDI
??	DDINO
麓	DDIXP
枺	DDJ
??	DDJV
樊	DDK
蠜	DDKLI
礬	DDKMR
攀	DDKQ
梀	DDL
楋	DDLN
樕	DDLO
禁	DDMMF
農	DDMMV
椲	DDMQ
??	DDMRT
??	DDNI
郴	DDNL
楚	DDNYO
??	DDOII
棽	DDOIN
棶	DDOO
懋	DDP
??	DDQ
婪	DDV
棟	DDW
楝	DDWF
??	DDWLI
??	DDYK
??	DE
??	DEA
??	DEED
棳	DEEE
桫	DEFH
杈	DEI
樑	DEID
頗	DEMBC
皯	DEMJ
??	DENL
皰	DEPRU
杰	DF
梢	DFB
??	DFBB
??	DFBC
橖	DFBD
欓	DFBF
樘	DFBG
橕	DFBH
??	DFBN
??	DFBQ
??	DFBR
檔	DFBW
??	DFD
橉	DFDQ
棪	DFF
??	DFFD
橩	DFFN
??	DFFR
橯	DFFS
杪	DFH
隸	DFLE
桄	DFMU
??	DFNO
柈	DFQ
棬	DFQU
杜	DG
柟	DGB
棱	DGCE
桂	DGG
槸	DGGI
橈	DGGU
榼	DGIT
檮	DGNI
樾	DGOV
檣	DGOW
??	DGP
桔	DGR
檯	DGRG
??	DGRR
榬	DGRV
樹	DGTI
??	DGTJ
櫝	DGWC
才	DH
柏	DHA
棉	DHAB
??	DHAE
楻	DHAG
槔	DHAJ
櫛	DHAL
??	DHBD
??	DHBK
鼒	DHBUL
??	DHBY
櫸	DHCQ
??	DHD
??	DHDA
楸	DHDF
??	DHDL
??	DHDN
橎	DHDW
皮	DHE
桻	DHEJ
??	DHEQ
格	DHER
柊	DHEY
檓	DHGE
??	DHGF
??	DHGI
梏	DHGR
??	DHGS
鸉	DHHAF
杉	DHHH
榭	DHHI
柳	DHHL
??	DHHM
??	DHHV
榴	DHHW
櫆	DHIJ
柉	DHIO
??	DHJ
櫡	DHJA
株	DHJD
椴	DHJE
棰	DHJM
栝	DHJR
??	DHJS
楯	DHJU
橋	DHKB
楀	DHLB
櫍	DHLC
??	DHLQ
??	DHME
析	DHML
梔	DHMU
柝	DHMY
机	DHN
??	DHNB
杸	DHNE
??	DHNG
楓	DHNI
桁	DHON
樅	DHOO
??	DHOR
??	DHP
棔	DHPA
柢	DHPM
??	DHQI
梆	DHQL
??	DHQM
柣	DHQO
??	DHQR
枆	DHQU
??	DHRB
楄	DHSB
??	DHSG
檄	DHSK
??	DHSM
??	DHSS
槴	DHSU
??	DHT
??	DHTC
??	DHTG
??	DHUA
欑	DHUC
槐	DHUI
??	DHUJ
??	DHUK
櫋	DHUS
橇	DHUU
柧	DHVO
椑	DHWJ
??	DHWS
??	DHX
楰	DHXO
??	DHXU
??	DHYB
樦	DHYG
??	DHYT
榹	DHYU
寸	DI
桹	DIAV
榑	DIBI
梭	DICE
??	DIE
??	DIFL
櫥	DIGI
槭	DIHF
椷	DIHR
??	DIHS
棧	DII
槮	DIIH
榔	DIIL
??	DIIQ
梂	DIJE
??	DIK
??	DIKJ
柭	DIKK
槦	DILB
??	DILE
栦	DILL
刌	DILN
??	DILO
榶	DILR
栨	DIMO
??	DINE
榳	DING
杙	DIP
樲	DIPC
栻	DIPM
檯	DIR
棫	DIRM
??	DIST
械	DIT
??	DIXE
??	DIXP
末	DJ
??	DJB
槙	DJBC
桲	DJBD
楠	DJBJ
??	DJBK
植	DJBM
柼	DJC
椌	DJCM
??	DJCN
榕	DJCR
榨	DJCS
??	DJCU
??	DJDI
枝	DJE
楁	DJHR
槫	DJII
??	DJIM
橞	DJIP
??	DJIV
橶	DJJI
杖	DJK
楮	DJKA
??	DJKF
栳	DJKP
栲	DJKS
棲	DJLV
檳	DJMC
棕	DJMF
楦	DJMM
椗	DJMO
梡	DJMU
??	DJMW
??	DJNU
??	DJOOG
柁	DJP
榰	DJPA
??	DJPB
??	DJPI
檸	DJPN
??	DJPU
枯	DJR
楜	DJRB
橭	DJRJ
棺	DJRR
??	DJT
橨	DJTC
??	DJTI
桉	DJV
??	DJVD
夬	DK
栯	DKB
樧	DKCE
橑	DKCF
??	DKDE
??	DKE
楏	DKGG
鷘	DKHAF
梑	DKHF
??	DKI
??	DKJJ
??	DKK
桸	DKKB
樉	DKKK
栫	DKLD
橢	DKMB
椅	DKMR
桍	DKMS
整	DKMYM
桋	DKN
??	DKNJ
槉	DKOK
梜	DKOO
憖	DKP
??	DKR
朸	DKS
槬	DKSO
枷	DKSR
束	DL
??	DLA
柍	DLBK
枕	DLBU
??	DLC
梊	DLD
??	DLDL
棣	DLE
??	DLG
皙	DLHA
??	DLII
??	DLKC
敕	DLKS
鶒	DLKSF
??	DLL
??	DLLL
蜤	DLLMI
剌	DLLN
樓	DLLV
樻	DLMC
桃	DLMO
棑	DLMY
賴	DLNBC
欶	DLNO
敕	DLOK
惁	DLP
??	DLPN
賴	DLSHC
??	DLVK
柚	DLW
柛	DLWL
梬	DLWS
橚	DLX
??	DLXH
棩	DLXL
本	DM
柏	DMA
桓	DMAM
檽	DMBB
槓	DMBC
櫌	DMBE
??	DMBI
栭	DMBL
欞	DMBO
櫺	DMBR
樗	DMBS
檑	DMBW
栖	DMCW
杅	DMD
極	DMEM
杯	DMF
檷	DMFB
枰	DMFJ
柸	DMFM
檦	DMFN
桮	DMFR
枉	DMG
??	DMGG
櫮	DMGR
梇	DMGT
榞	DMHF
櫪	DMHM
榗	DMIA
桎	DMIG
??	DMIT
杆	DMJ
??	DMJJ
橄	DMJK
??	DMJR
??	DMJS
梗	DMLK
栦	DMLL
椏	DMLM
柰	DMMF
枟	DMMI
??	DMMO
欐	DMMP
梧	DMMR
杇	DMMS
杬	DMMU
桭	DMMV
朾	DMN
桏	DMNL
栵	DMNN
柯	DMNR
柄	DMOB
柘	DMR
??	DMRB
韋	DMRQ
梪	DMRT
楅	DMRW
翉	DMSMM
椓	DMSO
枙	DMSU
枅	DMT
橛	DMTO
杌	DMU
榎	DMUE
枒	DMVH
??	DMVI
桱	DMVM
朽	DMVS
舝	DMVVQ
檟	DMWC
??	DMWD
標	DMWF
橝	DMWJ
橿	DMWM
??	DMWV
??	DMYM
??	DN
??	DNAI
橡	DNAO
??	DNBE
桷	DNBG
槲	DNBJ
??	DNBK
檞	DNBQ
檐	DNCR
李	DND
槂	DNDF
??	DNDT
??	DNEM
櫯	DNFD
杻	DNG
橘	DNHB
楙	DNHD
极	DNHE
??	DNHX
桶	DNIB
??	DNIH
??	DNIL
栘	DNIN
??	DNIQ
梃	DNKG
梴	DNKM
??	DNKN
楗	DNKQ
橢	DNLB
樄	DNLW
??	DNMP
桅	DNMU
杴	DNO
楈	DNOB
??	DNOE
楑	DNOK
橙	DNOT
揧	DNQ
榤	DNQD
欃	DNRI
??	DNSP
楹	DNST
凳	DNTN
??	DNUS
櫓	DNWA
??	DNWU
??	DNXU
??	DO
??	DOAE
枘	DOB
榷	DOBG
賚	DOBUC
栴	DOBY
柎	DODI
桼	DOE
椎	DOG
??	DOGD
樵	DOGF
榫	DOGJ
檇	DOGS
鶆	DOHAF
??	DOHG
??	DOI
柃	DOII
猌	DOIK
櫼	DOIM
枔	DOIN
棯	DOIP
槍	DOIR
杵	DOJ
枚	DOK
椥	DOKR
敕	DOKS
樇	DOLB
??	DOLH
??	DOLL
檜	DOMA
棆	DOMB
??	DOMC
梌	DOMD
栓	DOMG
楩	DOMK
??	DOML
??	DOMM
榆	DOMN
檢	DOMO
榆	DOMV
杚	DON
郲	DONL
來	DOO
桽	DOOG
杹	DOP
柂	DOPD
柞	DOS
??	DOTC
梅	DOWY
檎	DOYB
朼	DP
栒	DPA
杝	DPD
椈	DPFD
柲	DPH
榓	DPHT
杓	DPI
枃	DPIM
??	DPKP
杓	DPM
枃	DPMM
枇	DPP
楷	DPPA
梐	DPPG
枸	DPR
枹	DPRU
枻	DPT
楪	DPTD
杶	DPU
??	DPVK
杽	DQ
韞	DQABT
韜	DQBHX
韗	DQBJJ
韎	DQDJ
??	DQFB
韥	DQGWC
韟	DQHAJ
??	DQHAM
楔	DQHK
韍	DQIKK
梆	DQJL
槥	DQJM
椿	DQKA
榛	DQKD
??	DQKE
楱	DQKK
棒	DQKQ
??	DQKS
樁	DQKX
棈	DQMB
樍	DQMC
榡	DQMF
韖	DQNHD
郼	DQNL
枎	DQO
韐	DQOMR
槻	DQOU
韘	DQPTD
韌	DQSHI
韔	DQSMV
??	DQTLJ
韡	DQTMJ
韝	DQTTB
??	DQTWI
韣	DQWLI
韞	DQWOT
??	DQWTJ
韕	DQYRD
杏	DR
梋	DRB
??	DRBC
枳	DRC
桯	DRHG
梠	DRHR
柺	DRHS
柷	DRHU
??	DRJI
枴	DRKS
??	DRMG
枵	DRMS
橾	DRRD
樿	DRRJ
??	DRRR
??	DRRS
椵	DRSE
枴	DRSH
楫	DRSJ
椻	DSAV
??	DSEG
欘	DSEI
樨	DSEQ
榍	DSFB
??	DSG
??	DSHU
??	DSIP
檻	DSIT
栮	DSJ
棷	DSJE
椰	DSJL
椐	DSJR
桾	DSKR
櫃	DSLC
榧	DSLY
槢	DSMA
梫	DSME
櫂	DSMG
樛	DSMH
??	DSMI
栩	DSMM
柌	DSMR
檻	DSMT
棖	DSMV
樼	DSND
柩	DSNO
柅	DSP
榪	DSQF
梛	DSQL
檉	DSRG
樞	DSRR
柜	DSS
梮	DSSR
??	DSTT
榐	DSTV
杞	DSU
欖	DSWU
棤	DTA
模	DTAK
欗	DTAW
??	DTBF
??	DTBN
檬	DTBO
栱	DTC
欉	DTCE
??	DTCH
樸	DTCO
??	DTCT
楢	DTCW
欂	DTEI
樣	DTGE
榚	DTGF
檥	DTGI
檨	DTGO
橏	DTGR
樥	DTHJ
??	DTIS
??	DTIT
??	DTJF
??	DTJP
楛	DTJR
栚	DTK
楉	DTKR
樠	DTLB
橫	DTLC
??	DTLK
槿	DTLM
櫹	DTLX
柑	DTM
棋	DTMC
??	DTMD
樺	DTMJ
椹	DTMV
??	DTOD
檴	DTOE
??	DTOF
??	DTON
??	DTOP
榙	DTOR
??	DTOV
??	DTOX
槆	DTPA
??	DTPP
??	DTQ
槎	DTQM
權	DTRG
??	DTRJ
榵	DTSJ
櫙	DTSR
栟	DTT
構	DTTB
椪	DTTC
??	DTTM
橏	DTTR
??	DTVI
??	DTW
槽	DTWA
??	DTWD
樽	DTWI
??	DTWK
槏	DTXC
札	DU
??	DUCE
梤	DUCH
??	DUHJ
蚻	DULMI
椯	DUMB
榿	DUMT
??	DUNE
欈	DUOB
??	DUOI
梣	DUON
想	DUP
柮	DUU
紮	DUVIF
櫞	DVFO
櫟	DVID
機	DVII
柪	DVIS
朻	DVL
??	DVME
梉	DVMG
??	DVNE
椽	DVNO
欚	DVOI
樔	DVVD
??	DVVN
椔	DVVW
東	DW
柶	DWC
棵	DWD
柬	DWF
梩	DWG
鶇	DWHAF
棞	DWHD
槶	DWIM
??	DWJC
??	DWJI
棝	DWJR
??	DWK
柙	DWL
欏	DWLG
檡	DWLJ
楞	DWLS
檌	DWLY
椳	DWMV
??	DWOL
??	DWOT
楒	DWP
??	DWRW
樏	DWVF
欙	DWWF
櫑	DWWW
??	DWYI
朴	DY
??	DYAD
棹	DYAJ
楴	DYBB
楨	DYBC
櫳	DYBP
榜	DYBS
樀	DYCB
校	DYCK
橔	DYDK
槨	DYDL
櫬	DYDU
椒	DYFE
柱	DYG
楌	DYHH
??	DYHJ
杭	DYHN
槌	DYHR
枋	DYHS
樴	DYIA
??	DYIB
橀	DYIT
梳	DYIU
枓	DYJ
槤	DYJJ
??	DYK
楌	DYKH
柿	DYLB
檅	DYMH
櫏	DYMU
??	DYNB
橠	DYNV
椊	DYOJ
??	DYPD
榩	DYPK
樝	DYPM
櫨	DYPT
枮	DYR
櫧	DYRA
槁	DYRB
??	DYRD
椋	DYRF
楟	DYRN
檺	DYRO
欀	DYRV
??	DYSB
椸	DYSD
檹	DYSR
棜	DYSY
柆	DYT
橦	DYTG
樟	DYTJ
檖	DYTO
檍	DYTP
棓	DYTR
樈	DYTU
椄	DYTV
樆	DYUB
核	DYVO
??	DYVW
檁	DYWD
檀	DYWM
櫰	DYWV
櫅	DYX
水	E
汨	EA
淐	EAA
??	EAB
溫	EABT
??	EACC
灦	EAFC
滉	EAFU
涅	EAG
溡	EAGI
湦	EAHM
湄	EAHU
溉	EAIU
??	EAJA
泹	EAM
??	EAMG
湯	EAMH
淂	EAMI
涆	EAMJ
淏	EAMK
湜	EAMO
??	EAN
澗	EANA
澗	EANB
澖	EAND
灁	EANE
潤	EANG
灛	EANJ
潣	EANK
??	EANL
??	EANO
??	EANR
瀾	EANW
混	EAPP
渴	EAPV
瀑	EATE
??	EAV
濕	EAVF
漫	EAWE
??	EAWS
澋	EAYF
??	EAYK
??	EAYT
??	EB
溟	EBAC
淝	EBAU
淜	EBB
滑	EBBB
??	EBBQ
渦	EBBR
漞	EBBU
深	EBCD
??	EBCH
濺	EBCI
測	EBCN
浻	EBCR
瀴	EBCV
??	EBD
??	EBDI
??	EBE
淍	EBGR
??	EBHAF
??	EBHF
淫	EBHG
沉	EBHN
沉	EBHU
滔	EBHX
渾	EBJJ
鸂	EBKF
沮	EBM
湲	EBME
濦	EBMP
洞	EBMR
浮	EBND
漈	EBOF
懣	EBP
??	EBQR
泂	EBR
淨	EBSD
??	EBT
淚	EBU
浿	EBUC
灈	EBUG
渺	EBUH
湨	EBUK
濎	EBUL
涀	EBUU
浽	EBV
溪	EBVK
灂	EBWI
浵	EBYH
淦	EC
鍙	ECC
??	ECHE
滃	ECIM
滏	ECKC
涕	ECNH
浴	ECOR
沿	ECR
涗	ECRU
汾	ECSH
湓	ECST
潧	ECWA
沐	ED
渣	EDAM
盓	EDBT
湘	EDBU
淞	EDCI
淋	EDD
潸	EDDB
??	EDDD
澿	EDDF
漜	EDDG
灪	EDDH
滼	EDDN
濋	EDDO
??	EDF
塗	EDG
溎	EDGG
??	EDHA
波	EDHE
??	EDHH
淅	EDHL
沫	EDJ
決	EDK
涑	EDL
瀨	EDLC
??	EDLF
漱	EDLK
漱	EDLO
泍	EDM
顙	EDMBC
渿	EDMF
湋	EDMQ
漆	EDOE
淶	EDOO
??	EDOY
涷	EDW
湅	EDWF
??	EE
涾	EEA
??	EEC
淼	EEE
桑	EEED
敪	EEEEE
鵽	EEEEF
??	EEEEK
剟	EEEEN
欼	EEEEO
毲	EEEEU
疊	EEEM
汊	EEI
溞	EEII
碆	EEMR
??	EEQ
濷	EETB
婆	EEV
消	EFB
漟	EFBG
潎	EFBK
淌	EFBR
澢	EFBW
??	EFD
瀵	EFDC
潾	EFDQ
淡	EFF
??	EFFD
濴	EFFE
瀠	EFFF
瀅	EFFI
瀯	EFFR
澇	EFFS
沙	EFH
渻	EFHU
洸	EFMU
泮	EFQ
潫	EFQF
??	EFQN
圣	EG
淩	EGCE
淕	EGCG
濲	EGDE
??	EGDI
瀫	EGFE
洼	EGG
澆	EGGU
法	EGI
溘	EGIT
準	EGJ
浾	EGLC
濤	EGNI
濇	EGOW
??	EGP
洁	EGR
溒	EGRV
滶	EGSK
澎	EGTH
澍	EGTI
涬	EGTJ
瀆	EGWC
泊	EHA
??	EHAB
??	EHAE
湟	EHAG
滜	EHAJ
瀄	EHAL
澔	EHAR
澳	EHBK
??	EHBM
淛	EHBN
洫	EHBT
洎	EHBU
洀	EHBY
瀏	EHCN
??	EHD
潲	EHDB
潻	EHDE
湫	EHDF
浰	EHDN
溗	EHDP
??	EHDS
潘	EHDW
汳	EHE
??	EHEJ
??	EHEM
洚	EHEQ
洛	EHER
瀊	EHET
燙	EHF
??	EHG
浩	EHGR
洗	EHGU
泖	EHHL
派	EHHV
溜	EHHW
泛	EHIO
??	EHJ
洙	EHJD
湩	EHJG
活	EHJR
沃	EHK
??	EHKB
添	EHKP
潷	EHLQ
璗	EHMGI
沂	EHML
澨	EHMO
洉	EHMR
泝	EHMY
??	EHND
沒	EHNE
汎	EHNI
洬	EHNN
沿	EHNR
鯊	EHNWF
潃	EHOB
澓	EHOE
洐	EHON
漎	EHOO
??	EHP
涽	EHPA
泜	EHPM
挲	EHQ
涐	EHQI
湃	EHQJ
泩	EHQM
泆	EHQO
??	EHQR
溮	EHRB
??	EHRF
??	EHS
淭	EHSD
激	EHSK
??	EHSS
滬	EHSU
??	EHTO
??	EHUA
灒	EHUC
溾	EHUI
溴	EHUK
濞	EHUL
??	EHUT
娑	EHV
??	EHVF
泒	EHVO
汦	EHVP
??	EHWJ
??	EHWS
溲	EHXE
潟	EHXF
淣	EHXU
??	EHYE
裟	EHYHV
??	EHYT
叉	EI
浪	EIAV
溥	EIBI
浚	EICE
灖	EICY
梁	EID
灖	EIDY
??	EIE
粱	EIFD
??	EIFG
滅	EIHF
洠	EIHQ
減	EIHR
沇	EIHU
淺	EII
滲	EIIH
??	EIIL
浦	EIJB
沭	EIJC
??	EIJE
汱	EIK
溈	EIKF
沷	EIKK
沋	EIKU
滽	EILB
漮	EILE
洲	EILL
蚤	EILMI
溏	EILR
泳	EINE
澬	EIOC
涘	EIOK
??	EIOM
??	EIPB
瀌	EIPF
治	EIR
淢	EIRM
澸	EIRP
瀇	EITC
渡	EITE
??	EIUH
泧	EIV
??	EIWD
瀍	EIWG
漉	EIXP
汁	EJ
沛	EJB
滇	EJBC
浡	EJBD
溹	EJBF
湳	EJBJ
淔	EJBM
??	EJBT
灢	EJBV
泬	EJC
??	EJCG
湥	EJCK
涳	EJCM
溛	EJCO
溶	EJCR
沬	EJD
渤	EJDS
汥	EJE
??	EJFF
瀉	EJHF
浶	EJHQ
??	EJHR
瀋	EJHW
瀻	EJIC
??	EJID
漙	EJII
涋	EJIK
??	EJIM
潓	EJIP
渽	EJIR
??	EJIV
潮	EJJB
澣	EJJJ
漸	EJJL
瀚	EJJM
漧	EJJN
渚	EJKA
涍	EJKD
浤	EJKI
洘	EJKS
淒	EJLV
濱	EJMC
滱	EJME
淙	EJMF
渲	EJMM
泞	EJMN
淀	EJMO
浣	EJMU
涴	EJNU
??	EJOC
沱	EJP
??	EJPB
??	EJPH
??	EJPI
濘	EJPN
滵	EJPU
瀗	EJQP
沽	EJR
湖	EJRB
??	EJRK
涫	EJRR
濆	EJTC
??	EJTF
洝	EJV
??	EJVV
??	EJWJ
漃	EJYE
滓	EJYJ
汏	EK
洧	EKB
鋈	EKC
潦	EKCF
洃	EKF
??	EKHA
漪	EKHR
汰	EKI
渀	EKJT
淆	EKKB
漺	EKKK
洊	EKLD
??	EKLL
淹	EKLU
??	EKMR
洿	EKMS
洟	EKN
汍	EKNI
浹	EKOO
滯	EKPB
??	EKR
氻	EKS
泇	EKSR
沖	EL
??	ELA
泱	ELBK
沈	ELBU
??	ELC
垽	ELG
澅	ELGM
魙	ELHUI
??	ELIH
渱	ELIM
汌	ELLL
沸	ELLN
漶	ELLP
漊	ELLV
潰	ELMC
??	ELMI
洮	ELMO
濜	ELMT
??	ELMY
津	ELQ
??	ELSJ
??	ELV
湚	ELVU
油	ELW
??	ELWL
洩	ELWP
涄	ELWS
潚	ELX
泲	ELXH
淵	ELXL
江	EM
洹	EMAM
??	EMAN
濡	EMBB
??	EMBC
??	EMBD
瀀	EMBE
瀖	EMBG
澐	EMBI
渜	EMBK
洏	EMBL
??	EMBS
灀	EMBU
酒	EMCW
汙	EMD
??	EMEM
濔	EMFB
泙	EMFJ
??	EMFM
??	EMFU
汪	EMG
??	EMGB
涯	EMGG
濏	EMGH
源	EMHF
瀝	EMHM
溍	EMIA
洷	EMIG
汗	EMJ
??	EMJJ
澉	EMJK
活	EMJR
汙	EMJS
添	EMKP
浭	EMLK
洲	EMLL
沔	EMLS
澒	EMMC
沶	EMMF
沄	EMMI
灑	EMMP
浯	EMMR
污	EMMS
沅	EMMU
??	EMMV
汀	EMN
洌	EMNN
河	EMNR
瀦	EMOA
??	EMOC
沰	EMR
滆	EMRB
滒	EMRR
浢	EMRT
湢	EMRW
涿	EMSO
汧	EMT
濿	EMTB
潛	EMUA
灊	EMUB
漘	EMVB
溼	EMVG
溽	EMVI
涇	EMVM
??	EMVR
溧	EMWD
漂	EMWF
湮	EMWG
潭	EMWJ
湎	EMWL
??	EMWN
??	EMWU
漹	EMYF
??	EMYM
潒	ENAO
浼	ENAU
渙	ENBK
澥	ENBQ
湧	ENBS
澹	ENCR
染	END
沒	ENE
??	ENEM
??	ENFI
潏	ENHB
汲	ENHE
??	ENHS
淊	ENHX
汐	ENI
涌	ENIB
漒	ENII
??	ENIN
洺	ENIR
汛	ENJ
??	ENKG
涎	ENKM
湕	ENKQ
瀡	ENLB
濻	ENLC
滁	ENLD
??	ENLM
泐	ENLS
瀰	ENMB
溺	ENMM
洈	ENMU
澦	ENNC
??	ENO
湑	ENOB
潑	ENOE
湀	ENOK
澄	ENOT
滐	ENQD
瀺	ENRI
渳	ENSJ
??	ENST
漲	ENSV
??	ENWA
漁	ENWF
??	EO
??	EOAE
漡	EOAH
汭	EOB
盜	EOBT
??	EOBUC
泭	EODI
漵	EODK
淮	EOG
潗	EOGD
潐	EOGF
沴	EOHH
泠	EOII
洑	EOIK
瀸	EOIM
??	EOIN
淰	EOIP
滄	EOIR
汻	EOJ
瀿	EOKF
??	EOKP
滫	EOLB
滌	EOLD
浟	EOLK
??	EOLL
澮	EOMA
淪	EOMB
??	EOMC
涂	EOMD
??	EOMG
汽	EOMN
澰	EOMO
洽	EOMR
渝	EOMV
汔	EON
滊	EOND
??	EONO
溣	EOOB
瀲	EOOK
沎	EOP
??	EOPD
潪	EORA
潝	EORM
??	EORN
渰	EORT
??	EOS
洢	EOSK
潕	EOTF
濮	EOTO
海	EOWY
??	EOYT
沁	EP
洵	EPA
??	EPBT
池	EPD
淗	EPFD
泌	EPH
沕	EPHH
淴	EPHP
湉	EPHR
汋	EPI
??	EPIM
??	EPKN
浺	EPL
??	EPM
??	EPMM
??	EPMR
淘	EPOU
沘	EPP
湝	EPPA
泃	EPR
泡	EPRU
沏	EPSH
泄	EPT
渫	EPTD
沌	EPU
洶	EPUK
渹	EPYR
??	EQBD
??	EQBU
堻	EQG
潔	EQHF
??	EQHK
浙	EQHL
湱	EQJR
湷	EQKA
溱	EQKD
溙	EQKE
湊	EQKK
??	EQKQ
清	EQMB
漬	EQMC
??	EQMF
??	EQNU
??	EQOA
??	EQOC
湁	EQOR
呇	ER
浥	ERAU
涓	ERB
溳	ERBC
浧	ERHG
??	ERHR
況	ERHU
濈	ERJI
??	ERMG
??	ERMK
潞	ERMR
惉	ERP
湣	ERPA
澡	ERRD
潬	ERRJ
??	ERRK
??	ERRS
湒	ERSJ
汜	ERU
潠	ERUC
洖	ERVK
泯	ERVP
澠	ERXU
浞	ERYO
??	ESAV
涮	ESBN
澱	ESCE
渠	ESD
灟	ESEI
沼	ESHR
浘	ESHU
澀	ESIM
涊	ESIP
濫	ESIT
洱	ESJ
潳	ESJA
灄	ESJJ
??	ESJL
涺	ESJR
涒	ESKR
??	ESLC
洍	ESLL
??	ESLR
??	ESMA
漏	ESMB
瀷	ESMC
浸	ESME
濯	ESMG
漻	ESMH
潯	ESMI
濢	ESMJ
泀	ESMR
濫	ESMT
??	ESMV
潺	ESND
匯	ESOG
泥	ESP
溤	ESQF
澼	ESRJ
漚	ESRR
洰	ESS
氾	ESU
??	ESUF
淈	ESUU
灠	ESWU
??	ETAB
漠	ETAK
灡	ETAW
淟	ETBC
湔	ETBN
濛	ETBO
洪	ETC
潽	ETCA
澲	ETCD
??	ETCE
濝	ETCF
??	ETCG
澌	ETCL
??	ETCO
??	ETCP
溢	ETCT
港	ETCU
漾	ETGE
溔	ETGF
濧	ETGI
渼	ETGK
??	ETGO
濭	ETGT
瀳	ETIF
漭	ETIT
??	ETJP
浂	ETK
??	ETKL
??	ETKN
渃	ETKR
滿	ETLB
潢	ETLC
渶	ETLK
漢	ETLO
瀟	ETLX
泔	ETM
??	ETMA
??	ETMB
??	ETMBC
淇	ETMC
澕	ETMJ
渮	ETMR
湛	ETMV
濩	ETOE
灘	ETOG
??	ETOR
瀁	ETOV
濍	ETPP
洋	ETQ
溠	ETQM
灌	ETRG
灆	ETST
洴	ETT
溝	ETTB
湴	ETTC
??	ETTM
??	ETTN
灩	ETTU
溯	ETUB
??	ETUI
??	ETVG
滋	ETVI
濨	ETVP
浀	ETW
漕	ETWA
澫	ETWB
??	ETWE
瀎	ETWI
??	ETWK
澧	ETWT
濃	ETWV
溓	ETXC
淽	ETYM
??	ETYO
淓	ETYS
??	ETYT
汕	EU
??	EUAP
漰	EUBB
鎏	EUC
澂	EUGK
??	EUHJ
??	EUJF
灃	EUJT
洶	EUK
??	EUKU
湍	EUMB
湠	EUMF
??	EUMG
??	EUMGI
滍	EUMI
溰	EUMT
涵	EUNE
??	EUNO
漼	EUOG
涔	EUON
??	EUTC
??	EUTM
??	EUTN
灩	EUTT
灩	EUTU
泏	EUU
溦	EUUK
汝	EV
灤	EVFD
濰	EVFG
??	EVFH
灣	EVFN
??	EVFR
??	EVHI
濼	EVID
??	EVIO
泑	EVIS
淥	EVNE
洳	EVR
灉	EVUG
漅	EVVD
??	EVVU
淄	EVVW
沺	EW
渭	EWB
泗	EWC
淉	EWD
潿	EWDQ
溿	EWFQ
浬	EWG
潶	EWGF
??	EWGI
漍	EWIM
涸	EWJR
洇	EWK
湡	EWLB
濁	EWLI
澤	EWLJ
瀱	EWLN
潀	EWLO
澴	EWLV
淠	EWML
溷	EWMO
渨	EWMV
歠	EWNO
泅	EWO
??	EWOL
溫	EWOT
洄	EWR
??	EWT
潩	EWTC
滭	EWTJ
漯	EWVF
灅	EWWG
淖	EYAJ
渧	EYBB
湞	EYBC
灕	EYBG
澈	EYBK
瀧	EYBP
滂	EYBS
濬	EYBU
??	EYCA
滴	EYCB
洨	EYCK
滾	EYCV
潡	EYDK
漷	EYDL
瀙	EYDU
澯	EYED
瀣	EYEM
淑	EYFE
注	EYG
瀕	EYHC
滻	EYHM
沆	EYHN
汸	EYHS
淯	EYIB
流	EYIU
灨	EYJC
漣	EYJJ
汶	EYK
??	EYKB
滻	EYKM
沛	EYLB
瀢	EYLC
涉	EYLH
沚	EYLM
濊	EYMH
??	EYMM
泚	EYMP
??	EYMY
瀛	EYNC
??	EYNO
瀛	EYNV
淬	EYOJ
液	EYOK
滹	EYPD
澞	EYPK
淲	EYPN
澽	EYPO
濾	EYPP
瀘	EYPT
淲	EYPU
沾	EYR
滈	EYRB
淳	EYRD
涼	EYRF
滸	EYRJ
渟	EYRN
濠	EYRO
湸	EYRU
瀼	EYRV
??	EYRW
游	EYSD
??	EYSG
漩	EYSO
淤	EYSY
泣	EYT
湆	EYTA
湇	EYTB
潼	EYTG
漳	EYTJ
澺	EYTP
涪	EYTR
??	EYTU
漓	EYUB
滮	EYUH
汒	EYV
澭	EYVG
泫	EYVI
滀	EYVW
凜	EYWD
滷	EYWI
澶	EYWM
瀤	EYWV
濟	EYX
汴	EYY
火	F
??	FAA
焨	FAB
熅	FABT
熀	FAFU
煋	FAHM
焺	FAHT
煝	FAHU
炟	FAM
煬	FAMH
焊	FAMJ
燘	FANK
燜	FANP
爛	FANW
爓	FANX
??	FAPH
焜	FAPP
??	FARF
??	FASE
爆	FATE
燁	FATJ
??	FAU
??	FAVF
熳	FAWE
??	FAYF
煜	FAYT
肖	FB
熐	FBAC
??	FBB
燰	FBBE
??	FBBR
炯	FBCR
??	FBF
??	FBG
鶺	FBHAF
煇	FBJJ
燃	FBKF
削	FBLN
煖	FBME
烔	FBMR
烰	FBND
敝	FBOK
??	FBOU
??	FBQJK
尚	FBR
賞	FBRBC
棠	FBRD
堂	FBRG
党	FBRHU
常	FBRLB
牚	FBRMH
瓽	FBRMN
嘗	FBRPA
掌	FBRQ
??	FBRTM
當	FBRW
黨	FBRWF
裳	FBRYV
??	FBTK
??	FBTL
??	FBTU
??	FBTV
爝	FBWI
??	FBY
烿	FBYH
??	FC
脊	FCB
炂	FCI
??	FCIP
焍	FCNH
焀	FCOR
米	FD
糧	FDAMG
??	FDAPH
粑	FDAU
??	FDBBM
粗	FDBM
粡	FDBMR
??	FDBND
粣	FDBT
粯	FDBUU
粉	FDCSH
??	FDD
??	FDDD
爩	FDDH
籿	FDDI
粖	FDDJ
糔	FDEII
??	FDFBG
??	FDGRR
粕	FDHA
??	FDHAB
??	FDHDS
粄	FDHE
??	FDHGF
粁	FDHJ
??	FDHNI
糌	FDHOA
粍	FDHQU
糗	FDHUK
粺	FDHWJ
??	FDHYA
??	FDIAV
糐	FDIBI
??	FDIDD
粧	FDIG
糝	FDIIH
??	FDIJC
糠	FDILE
??	FDILO
糖	FDILR
麊	FDIXP
籵	FDJ
??	FDJII
粀	FDJK
??	FDJKP
粽	FDJMF
??	FDJR
糊	FDJRB
炔	FDK
??	FDLLL
??	FDLW
粨	FDMA
糯	FDMBB
??	FDMBE
粞	FDMCW
??	FDMJ
粳	FDMLK
煒	FDMQ
??	FDMRT
糲	FDMTB
糎	FDMWG
??	FDMWL
??	FDNBQ
籽	FDND
粈	FDNG
糅	FDNHD
糨	FDNII
??	FDNIQ
籸	FDNJ
粌	FDNL
糑	FDNMM
糈	FDNOB
??	FDOIR
敉	FDOK
??	FDOMO
籺	FDON
??	FDONK
??	FDOPD
粅	FDPHH
??	FDPP
??	FDPT
精	FDQMB
??	FDQO
??	FDRC
??	FDRHR
??	FDRSE
??	FDSHI
糮	FDSIT
??	FDSMT
粻	FDSMV
米	FDSO
粔	FDSS
糢	FDTAK
糷	FDTAW
糋	FDTBN
糕	FDTGF
糒	FDTHB
??	FDTM
??	FDTMC
??	FDTMV
??	FDTOP
??	FDTVI
??	FDTW
糟	FDTWA
??	FDU
??	FDUCE
籹	FDV
??	FDW
粿	FDWD
煉	FDWF
粴	FDWG
??	FDWIM
糰	FDWJI
糬	FDWLA
糞	FDWTC
烞	FDY
??	FDYED
??	FDYFE
??	FDYG
??	FDYHN
糙	FDYHR
料	FDYJ
??	FDYK
粹	FDYOJ
粘	FDYR
粒	FDYT
??	FDYTU
??	FE
炎	FF
膋	FFBB
覮	FFBBU
鎣	FFBC
??	FFBCT
榮	FFBD
??	FFBDD
滎	FFBE
爣	FFBF
塋	FFBG
鶯	FFBHF
??	FFBHN
犖	FFBHQ
勞	FFBKS
螢	FFBLI
禜	FFBMF
瑩	FFBMI
甇	FFBMN
醟	FFBMW
煢	FFBNJ
罃	FFBOU
營	FFBRR
覢	FFBUU
嫈	FFBV
縈	FFBVF
謍	FFBYR
褮	FFBYV
??	FFC
燐	FFDQ
燮	FFE
焱	FFF
燊	FFFD
燚	FFFF
??	FFFS
??	FFG
炒	FFH
??	FFHAF
??	FFHJR
飆	FFHNI
??	FFHQU
??	FFJE
剡	FFLN
纇	FFMBC
郯	FFNL
欻	FFNO
??	FFOG
??	FFQL
敥	FFYE
??	FFYF
虩	FFYPU
煔	FFYR
灶	FG
??	FGBT
??	FGCC
??	FGCG
烓	FGG
燒	FGGU
熆	FGIT
??	FGLC
燽	FGNI
??	FGP
??	FGRF
熹	FGRR
少	FH
??	FHAF
煌	FHAG
燠	FHBK
烅	FHBT
省	FHBU
??	FHD
煍	FHDF
??	FHDL
熪	FHDN
??	FHDS
燔	FHDW
烽	FHEJ
??	FHEQ
烙	FHER
炵	FHEY
??	FHFS
燬	FHGE
燻	FHGF
烍	FHGU
??	FHJD
鍛	FHJE
煄	FHJG
??	FHJU
燆	FHKB
劣	FHKS
焮	FHLO
??	FHLQ
燬	FHME
炘	FHML
??	FHNE
??	FHNF
??	FHNI
烆	FHON
爐	FHS
煸	FHSB
煽	FHSM
熩	FHSU
??	FHT
??	FHUC
??	FHUK
熄	FHUP
??	FHWJ
熜	FHWP
??	FHXC
烺	FIAV
??	FIBI
焌	FICE
??	FIHF
煘	FIHR
烳	FIJB
??	FIJE
??	FILE
蠽	FILII
??	FILO
煻	FILR
爊	FIPF
烒	FIPM
爌	FITC
??	FITF
熝	FIXP
??	FJAE
??	FJBC
??	FJBF
??	FJBJ
??	FJBM
焢	FJCM
熔	FJCR
烢	FJHP
??	FJKF
烤	FJKS
??	FJMC
??	FJMF
??	FJMM
烷	FJMU
焥	FJNU
??	FJP
??	FJRR
尖	FK
??	FKA
烠	FKB
瞥	FKBU
??	FKC
燎	FKCF
??	FKF
煃	FKGG
鷩	FKHAF
氅	FKHQU
獘	FKIK
??	FKITC
烯	FKKB
幣	FKLB
??	FKLD
蟞	FKLMI
類	FKMBC
斃	FKMNP
彆	FKN
鱉	FKNWF
憋	FKP
??	FKQ
鄨	FKRAU
鱉	FKRXU
蹩	FKRYO
熁	FKSB
燲	FKSC
弊	FKT
嫳	FKV
??	FKYHS
炴	FLBK
??	FLBU
爞	FLII
熡	FLLV
烑	FLMO
燼	FLMT
??	FLN
??	FLWL
熽	FLX
灴	FM
烜	FMAM
燸	FMBB
煩	FMBC
??	FMBE
??	FMBI
爧	FMBO
??	FMBU
??	FMED
??	FMF
??	FMFJ
??	FMG
??	FMHM
??	FMLM
焐	FMMR
燈	FMN
??	FMNR
炳	FMOB
??	FMRW
烼	FMSO
??	FMTB
光	FMU
熸	FMUA
烴	FMVM
熛	FMWF
煙	FMWG
燂	FMWJ
炡	FMYM
??	FNAU
煥	FNBK
??	FNBQ
??	FNEF
炄	FNG
燏	FNHB
煣	FNHD
焰	FNHX
烶	FNKG
烻	FNKM
煡	FNKQ
??	FNL
??	FNMP
炊	FNO
燈	FNOT
揱	FNQ
??	FNSP
??	FNWF
尐	FO
??	FOAM
??	FOD
雀	FOG
燋	FOGF
炩	FOII
??	FOIP
熗	FOIR
??	FOLL
燴	FOMA
爚	FOMB
烇	FOMG
烚	FOMR
熂	FOND
灺	FOPD
炸	FOS
烸	FOWY
灺	FPD
灼	FPI
灼	FPM
??	FPPA
炮	FPRU
煠	FPTD
炖	FPU
半	FQ
眷	FQBU
韏	FQDMQ
叛	FQHE
牶	FQHQ
??	FQIAV
帣	FQLB
判	FQLN
??	FQMB
頖	FQMBC
豢	FQMSO
甐	FQMVN
弮	FQN
觠	FQNBG
鄰	FQNL
??	FQNWF
拳	FQQ
券	FQSH
翷	FQSMM
??	FQSQF
卷	FQSU
亃	FQU
絭	FQVIF
粼	FQVV
齤	FQYMU
??	FR
焆	FRB
熉	FRBC
??	FRHG
??	FRHR
炾	FRHU
??	FRMG
燥	FRRD
燀	FRRJ
煰	FRRR
煆	FRSE
??	FSEF
熞	FSEG
燭	FSEI
??	FSEQ
灱	FSH
炤	FSHR
焰	FSHX
爁	FSIT
??	FSLL
熠	FSMA
燿	FSMG
燖	FSMI
??	FSMJ
??	FSMT
??	FSRG
熰	FSRR
炬	FSS
焗	FSSR
爦	FSWU
??	FT
焟	FTA
??	FTAW
??	FTBD
??	FTBF
烘	FTC
??	FTCE
煪	FTCW
燨	FTGI
??	FTGR
爔	FTGS
??	FTHF
??	FTHS
??	FTK
熿	FTLC
??	FTLF
煂	FTLJ
煐	FTLK
熯	FTLO
煤	FTMD
燁	FTMJ
煁	FTMV
??	FTOB
??	FTOF
??	FTPI
??	FTPO
??	FTPP
烊	FTQ
爟	FTRG
??	FTT
??	FTTR
燤	FTWB
燇	FTWI
??	FTWR
??	FU
??	FUAP
輝	FUBJJ
??	FUBUG
??	FUFMU
??	FUGGU
??	FUHJ
??	FUHUI
??	FUITC
??	FUKS
煓	FUMB
??	FUMF
??	FUMT
??	FUOG
耀	FUSMG
??	FUTMC
??	FUYTO
爍	FVID
??	FVIT
??	FW
煟	FWB
??	FWD
爅	FWGG
煙	FWK
??	FWKP
燭	FWLI
燡	FWLJ
??	FWLM
顲	FWMBC
煨	FWMV
熅	FWOT
熼	FWTC
熚	FWTJ
焯	FYAJ
??	FYAS
??	FYBP
??	FYCB
??	FYCK
燉	FYDK
燦	FYED
??	FYEV
炷	FYG
??	FYGQ
??	FYHC
??	FYHJ
炕	FYHN
??	FYHS
熾	FYIA
??	FYIB
炓	FYJ
??	FYJJ
炆	FYK
熥	FYNB
焠	FYOJ
焲	FYOK
??	FYPP
爐	FYPT
??	FYR
熇	FYRB
焞	FYRD
爙	FYRV
??	FYT
??	FYTA
??	FYTG
??	FYTJ
燧	FYTO
燱	FYTP
焙	FYTR
??	FYV
炫	FYVI
烗	FYVO
??	FYWM
土	G
塭	GABT
塒	GAGI
??	GAHM
堳	GAHU
坦	GAM
場	GAMH
罈	GAMI
堤	GAMO
壛	GANX
埸	GAPH
堨	GAPV
塌	GASM
垠	GAV
墁	GAWE
??	GAYF
??	GAYT
冉	GB
塓	GBAC
堋	GBB
??	GBBM
堝	GBBR
堔	GBCD
??	GBCR
埰	GBD
埒	GBDI
??	GBHN
觳	GBHNE
??	GBHX
??	GBJJ
壺	GBLM
埧	GBMC
??	GBME
壼	GBMM
塚	GBMO
垌	GBMR
壹	GBMT
垺	GBND
??	GBOU
??	GBP
坰	GBR
埩	GBSD
??	GBT
堈	GBTU
??	GBU
??	GBUC
??	GBWI
坍	GBY
覿	GCBUU
皾	GCDHE
坴	GCG
赫	GCGLC
夌	GCHE
赯	GCILR
塕	GCIM
赭	GCJKA
赨	GCLMI
??	GCMBC
赩	GCNAU
郝	GCNL
赦	GCOK
??	GCOND
赮	GCRSE
鼀	GCRXU
坋	GCSH
赧	GCSLE
增	GCWA
赬	GCYBC
坡	GDHE
穀	GDHNE
寺	GDI
??	GDMQ
埬	GDW
堜	GDWF
??	GE
瞽	GEBU
鏧	GEC
漀	GEE
鼜	GEEII
鼞	GEFBG
馨	GEHDA
鼕	GEHEY
毊	GEHKB
鼛	GEHOR
鼙	GEHWJ
??	GEJWJ
螜	GELMI
鼘	GELXL
磬	GEMR
??	GEMYM
罄	GEOJU
愨	GEP
擊	GEQ
??	GESHR
聲	GESJ
鼚	GESMV
??	GEVIF
謦	GEYMR
韾	GEYTA
??	GFBW
塉	GFCB
埮	GFF
縠	GFHNE
垙	GFMU
款	GFNO
坢	GFQ
??	GFQG
埢	GFQU
圭	GG
堎	GGCE
封	GGDI
燅	GGFF
垚	GGG
堯	GGGU
鵱	GGHAF
??	GGHNE
埶	GGKNI
??	GGKS
刲	GGLN
壔	GGNI
邽	GGNL
墻	GGOW
恚	GGP
??	GGRXU
??	GGTH
奊	GGVK
卦	GGY
堭	GHAG
??	GHAU
墺	GHBK
??	GHDP
墦	GHDW
阪	GHE
??	GHEJ
??	GHER
垀	GHFD
??	GHFS
壎	GHGF
??	GHGR
塯	GHHW
堹	GHJG
埵	GHJM
??	GHJU
??	GHKB
??	GHLMI
??	GHLO
圻	GHML
垢	GHMR
甏	GHMVN
坼	GHMY
垛	GHND
堸	GHNI
??	GHOG
??	GHOR
坻	GHPM
??	GHQL
??	GHQM
??	GHQR
塢	GHRF
埠	GHRJ
??	GHRR
??	GHS
墽	GHSK
塊	GHUI
坁	GHVP
埤	GHWJ
??	GHWS
堄	GHXU
去	GI
??	GIA
朅	GIAPV
埌	GIAV
盍	GIBT
贄	GIBUC
??	GICE
槷	GID
熱	GIF
墊	GIG
幫	GIHAB
鷙	GIHAF
??	GIHF
犎	GIHQ
堿	GIHR
城	GIHS
??	GIHUI
墋	GIIH
埔	GIJB
勢	GIKS
墉	GILB
??	GILE
??	GILL
蟄	GILMI
劫	GILN
??	GILO
塘	GILR
邿	GINL
垿	GINN
埃	GIOK
慹	GIP
摯	GIQ
??	GIR
域	GIRM
鼁	GIRXU
卻	GISL
翿	GISMM
騺	GISQF
??	GIST
壙	GITC
鞤	GITLJ
縶	GIVIF
塶	GIXP
謺	GIYMR
??	GJB
填	GJBC
埴	GJBM
??	GJCN
塎	GJCR
轂	GJHNE
垞	GJHP
瓡	GJHVO
塼	GJII
墘	GJJN
堵	GJKA
??	GJKF
執	GJKNI
??	GJMD
??	GJMM
??	GJMO
垸	GJMU
??	GJNU
坨	GJP
??	GJR
報	GJSLE
墳	GJTC
垵	GJV
盩	GKBT
贅	GKBUC
鏊	GKC
熬	GKF
獒	GKIK
塽	GKKK
螯	GKLMI
堶	GKMB
埼	GKMR
垮	GKMS
鰲	GKNWF
墆	GKPB
摮	GKQ
鼇	GKRXU
??	GKSB
聱	GKSJ
驁	GKSQF
謷	GKYMR
坱	GLBK
埭	GLE
圳	GLLL
坲	GLLN
塿	GLLV
垗	GLMO
??	GLMS
赤	GLNC
垏	GLQ
坤	GLWL
垣	GMAM
壩	GMBB
??	GMBC
??	GMBI
堧	GMBK
鋆	GMC
圩	GMD
坏	GMF
坪	GMFJ
坯	GMFM
堐	GMGG
壢	GMHM
垤	GMIG
??	GMJS
埂	GMLK
埡	GMLM
??	GMMI
??	GMMR
圬	GMMS
??	GMMU
圢	GMN
坷	GMNR
??	GMR
塥	GMRB
堛	GMRW
??	GMUE
??	GMVM
壩	GMWB
塛	GMWD
墂	GMWF
堙	GMWG
??	GMWJ
??	GMWM
堍	GNAI
埆	GNBG
圾	GNHE
殼	GNHNE
埳	GNHX
??	GNI
埇	GNIB
??	GNKG
埏	GNKM
燾	GNMF
壽	GNMI
垝	GNMU
坎	GNO
婿	GNOB
墱	GNOT
??	GNSD
??	GNYE
場	GOAH
趕	GOAMJ
趧	GOAMO
趄	GOBM
??	GOBMR
趛	GOC
??	GODI
赽	GODK
趙	GOFB
趟	GOFBR
赻	GOFH
堆	GOG
趬	GOGGU
趌	GOGR
??	GOGYO
??	GOHAE
趎	GOHJD
趏	GOHJR
趫	GOHKB
趓	GOHND
豰	GOHNE
??	GOHON
??	GOHQM
趲	GOHUC
坽	GOII
垘	GOIK
趑	GOIMO
坅	GOIN
??	GOIOK
趑	GOIOR
??	GOIP
越	GOIV
??	GOJD
??	GOJMR
??	GOK
赲	GOKS
??	GOLL
趒	GOLMO
趀	GOLXH
坵	GOM
??	GOMB
??	GOMFB
赶	GOMJ
??	GOMJR
趑	GOMMO
堬	GOMN
趔	GOMNN
??	GOMOR
垥	GOMR
??	GOMV
??	GOMWL
??	GOMYS
圪	GON
??	GONF
趍	GONIN
堠	GONK
??	GONNO
??	GONO
超	GONR
??	GONSD
??	GOO
趡	GOOG
趭	GOOGF
趁	GOOHH
??	GOOII
??	GOOIR
趖	GOOOG
??	GOP
趜	GOPFD
??	GOPIM
赹	GOPMM
趨	GOPUU
??	GOQO
??	GORBC
??	GORD
趮	GORRD
起	GORU
超	GOSHR
??	GOSHU
趣	GOSJE
趯	GOSMG
趐	GOSMM
??	GOSO
??	GOSQF
起	GOSU
趥	GOTCW
??	GOTKR
趪	GOTLC
赸	GOU
??	GOUA
??	GOUMR
趉	GOUU
赳	GOVL
嗇	GOWR
??	GOWTC
赴	GOY
趠	GOYAJ
??	GOYT
志	GP
??	GPA
覟	GPBUU
地	GPD
圴	GPI
均	GPIM
??	GPM
均	GPMM
階	GPPA
??	GPPP
??	GPRHU
堞	GPTD
坉	GPU
垹	GQJL
??	GQKD
埲	GQKQ
埥	GQMB
??	GQMF
吉	GR
塤	GRBC
臺	GRBG
??	GRBUC
??	GRGR
囍	GRGRR
鴶	GRHAF
埕	GRHG
嗀	GRHNE
袁	GRHV
劼	GRKS
頡	GRMBC
??	GRMFM
嚭	GRMFR
??	GRMG
??	GRNL
歖	GRNO
墠	GRRJ
壧	GRRK
堮	GRRS
喪	GRRV
??	GRSMM
壴	GRT
熹	GRTF
??	GRTP
喜	GRTR
圯	GRU
??	GRVP
敼	GRYE
堰	GSAV
??	GSE
墀	GSEQ
??	GSHU
??	GSHX
壏	GSIT
壣	GSJT
埽	GSMB
埐	GSME
??	GSMT
敖	GSOK
坭	GSP
??	GSRJ
??	GSTT
圮	GSU
堀	GSUU
塻	GTAK
??	GTCA
??	GTCG
墣	GTCO
塨	GTCP
??	GTDHE
尌	GTDI
墡	GTGR
壒	GTGT
彭	GTHHH
??	GTHU
懿	GTIOP
幸	GTJ
鼓	GTJE
??	GTLC
墐	GTLM
坩	GTM
??	GTMA
??	GTMC
懿	GTMOP
堪	GTMV
??	GTOG
??	GTOK
塔	GTOR
垟	GTQ
??	GTRG
壾	GTSS
墡	GTTR
亄	GTU
墈	GTVS
墫	GTWI
??	GTYS
圠	GU
??	GUAP
塴	GUBB
??	GUCE
瞉	GUHNE
顤	GUMBC
??	GUMJ
塏	GUMT
墔	GUOG
埁	GUON
??	GURK
翹	GUSMM
坳	GVIS
堁	GWD
埋	GWG
毐	GWJ
堌	GWJR
堣	GWLB
賣	GWLC
墿	GWLJ
堽	GWLM
??	GWLW
??	GWMV
??	GWOL
塭	GWOT
??	GWR
坶	GWYI
??	GY
??	GYBC
??	GYBP
塝	GYBS
墑	GYCB
??	GYCK
墩	GYDK
墎	GYDL
埱	GYFE
坑	GYHN
坊	GYHS
堉	GYIB
??	GYK
壝	GYLC
??	GYLH
址	GYLM
??	GYM
走	GYO
埣	GYOJ
墟	GYPM
壉	GYPO
壚	GYPT
坫	GYR
塙	GYRB
埻	GYRD
壕	GYRO
壤	GYRV
??	GYSQ
??	GYSV
垃	GYT
堷	GYTA
墥	GYTG
墇	GYTJ
??	GYTP
培	GYTR
境	GYTU
??	GYVD
??	GYVI
垓	GYVO
壈	GYWD
??	GYWI
壇	GYWM
壞	GYWV
竹	H
白	HA
馧	HAABT
皭	HABWI
??	HACSH
泉	HAE
灥	HAEHE
??	HAEJ
𤽄	HAF
??	HAFHH
??	HAFMU
皛	HAHAA
??	HAHAJ
皤	HAHDW
皈	HAHE
皓	HAHGR
皒	HAHQI
??	HAHQR
皦	HAHSK
魄	HAHUI
??	HAII
節	HAIL
皫	HAIPF
皁	HAJ
馞	HAJBD
??	HAJMC
??	HAJMM
皖	HAJMU
??	HAJNU
??	HAJTC
皋	HAKJ
馣	HAKLU
帛	HALB
馡	HALMY
笪	HAM
??	HAMBC
皇	HAMG
筸	HAMJ
簡	HANA
簢	HANK
籣	HANW
馥	HAOAE
皊	HAOII
??	HAOK
皂	HAP
馝	HAPH
的	HAPI
??	HAPP
??	HAQMB
??	HAQMC
馜	HASP
皏	HATT
馦	HATXC
笆	HAU
皚	HAUMT
皪	HAVID
簋	HAVT
??	HAW
??	HAWD
馧	HAWOT
??	HAYBS
皎	HAYCK
梟	HAYD
鳥	HAYF
皉	HAYMP
皜	HAYRB
島	HAYU
裊	HAYV
舋	HBBM
覺	HBBUU
爨	HBDDF
澩	HBE
燢	HBF
籐	HBFE
壆	HBG
鶣	HBHAF
嚳	HBHGR
綿	HBHVF
奧	HBK
筋	HBKS
制	HBLN
籲	HBMBC
釁	HBMCH
璺	HBMGI
筒	HBMR
箸	HBMS
甂	HBMVN
觷	HBNBG
學	HBND
鄅	HBNL
鱟	HBNWF
??	HBOG
敿	HBOK
甪	HBQ
向	HBR
箏	HBSD
箙	HBSE
翩	HBSMM
血	HBT
黌	HBTLC
??	HBTV
自	HBU
??	HBUD
纂	HBUF
篎	HBUH
篡	HBUI
算	HBUT
筧	HBUU
舟	HBYI
??	HCA
鸒	HCHAF
??	HCHB
籦	HCHG
籛	HCII
轝	HCJWJ
劉	HCLN
??	HCMBC
釁	HCMCH
礜	HCMR
酇	HCNL
歟	HCNO
舉	HCQ
嬃	HCV
籙	HCVE
譽	HCYMR
禾	HD
香	HDA
穊	HDAIU
稈	HDAMJ
策	HDB
稱	HDBGB
稠	HDBGR
稻	HDBHX
租	HDBM
穩	HDBMP
??	HDBN
稃	HDBND
穄	HDBOF
稠	HDBQR
盉	HDBT
箱	HDBU
??	HDBW
穱	HDBWI
??	HDCI
??	HDCIP
稊	HDCNH
稅	HDCRU
秎	HDCSH
箖	HDD
秣	HDDJ
稦	HDDMQ
??	HDDPU
秋	HDF
??	HDFA
稍	HDFB
秒	HDFH
稜	HDGCE
稑	HDGCG
穘	HDGGU
穡	HDGOW
秸	HDGR
鴸	HDHAF
穆	HDHAH
秝	HDHD
??	HDHGU
種	HDHJG
??	HDHK
穚	HDHKB
毇	HDHNE
秅	HDHP
秪	HDHPM
秩	HDHQO
秏	HDHQU
稨	HDHSB
禿	HDHU
秖	HDHVP
稗	HDHWJ
私	HDI
稂	HDIAV
稄	HDICE
??	HDID
穇	HDIIH
秫	HDIJC
??	HDIJE
??	HDILB
??	HDILE
??	HDINE
穮	HDIPF
??	HDIPM
秮	HDIR
稢	HDIRM
穬	HDITC
稽	HDIUA
嵇	HDIUU
稹	HDJBC
稙	HDJBM
??	HDJD
秺	HDJHP
穗	HDJIP
??	HDJMC
稼	HDJMO
??	HDJPU
稀	HDKKB
秉	HDL
秧	HDLBK
籟	HDLC
利	HDLN
簌	HDLO
乘	HDLP
釉	HDLW
秭	HDLXH
笨	HDM
??	HDMBB
??	HDMFB
秤	HDMFJ
秠	HDMFM
秷	HDMIG
??	HDMJ
??	HDMMP
稫	HDMRW
甈	HDMVN
??	HDNBG
季	HDND
秀	HDNHS
移	HDNIN
邾	HDNL
臲	HDNMU
稰	HDNOB
??	HDNRU
穭	HDNWA
??	HDNXU
??	HDOAE
黍	HDOE
稚	HDOG
穛	HDOGF
??	HDOHG
稔	HDOIP
??	HDOLL
稐	HDOMB
稌	HDOMD
??	HDOMR
箂	HDOO
悉	HDP
秘	HDPH
秕	HDPP
??	HDPPA
積	HDQMC
和	HDR
程	HDRHG
程	HDRMG
??	HDSB
??	HDSEQ
??	HDSL
穋	HDSMH
??	HDSMM
秜	HDSP
秬	HDSS
??	HDSYJ
稓	HDTA
??	HDTGI
穔	HDTLC
稘	HDTMC
穫	HDTOE
??	HDTSJ
穠	HDTWV
秈	HDU
稯	HDUCE
??	HDUNE
??	HDUON
委	HDV
穖	HDVII
番	HDW
稷	HDWCE
稞	HDWD
??	HDWG
稛	HDWHD
稒	HDWJR
釋	HDWLJ
??	HDWTC
??	HDYE
??	HDYHN
科	HDYJ
穢	HDYMH
稿	HDYRB
稕	HDYRD
穰	HDYRV
穜	HDYTG
??	HDYTJ
穟	HDYTO
穧	HDYX
反	HE
篞	HEAG
簜	HEAH
篞	HEAM
盤	HEBT
??	HEC
槃	HED
??	HEDK
垼	HEG
箔	HEHA
籓	HEHW
簿	HEII
箈	HEIR
幋	HELB
??	HEMJ
磐	HEMR
鄋	HENL
慇	HEP
??	HEPD
搫	HEQ
夆	HEQJ
各	HER
笵	HESU
篊	HETC
鞶	HETLJ
媻	HEV
縏	HEVIF
冬	HEY
褩	HEYHV
黏	HEYR
黐	HEYUB
鵿	HFAHT
鸔	HFATE
筲	HFB
箾	HFBN
簹	HFBW
??	HFC
乎	HFD
鴃	HFDK
??	HFDN
??	HFE
簩	HFFS
鶖	HFHAF
鳧	HFHN
??	HFHNI
??	HFHQU
鶳	HFHRB
箵	HFHU
??	HFHVF
??	HFHXU
鷈	HFHYU
鵔	HFICE
鴥	HFJC
鴕	HFJP
勳	HFKS
蝵	HFLMI
甃	HFMVN
鳦	HFN
鄔	HFNL
歍	HFNO
鵻	HFOG
鵌	HFOMD
愁	HFP
揫	HFQ
鷌	HFSQF
鸃	HFTGI
鶀	HFTMC
??	HFU
媝	HFV
??	HFVNE
鷻	HFYDK
壬	HG
??	HGBN
簭	HGCR
等	HGDI
濌	HGEA
熏	HGF
??	HGFA
皝	HGFMU
筀	HGG
毀	HGHNE
先	HGHU
丟	HGI
篕	HGIT
動	HGKS
顧	HGMBC
籌	HGNI
筠	HGPM
告	HGR
籉	HGRG
靠	HGRLY
篁	HHAG
??	HHAI
卿	HHAIL
??	HHBU
貿	HHBUC
??	HHC
??	HHD
射	HHDI
筣	HHDN
??	HHEY
躺	HHFBR
軂	HHFFS
筶	HHGR
筅	HHGU
彡	HHH
鵹	HHHAF
??	HHHDW
??	HHHJE
躲	HHHND
辵	HHHO
犁	HHHQ
??	HHIHR
??	HHIPM
??	HHJ
箠	HHJM
軉	HHJMC
筈	HHJR
笑	HHK
簥	HHKB
??	HHKS
擔	HHLBU
笊	HHLO
須	HHMBC
??	HHML
??	HHMMV
躬	HHN
??	HHNI
躲	HHNSD
鯬	HHNWF
黎	HHOE
篽	HHOL
??	HHOO
??	HHP
??	HHPFD
笙	HHQM
??	HHQU
篩	HHRB
??	HHRHR
??	HHRN
??	HHRRJ
躽	HHSAV
篇	HHSB
卯	HHSL
贕	HHSLC
孵	HHSLD
毈	HHSLE
卵	HHSLI
??	HHSMV
軀	HHSRR
??	HHTGK
??	HHTIS
??	HHTWT
籫	HHUC
??	HHUF
??	HHVO
留	HHW
??	HHWD
黧	HHWGF
箄	HHWJ
??	HHWP
籅	HHXC
篪	HHYU
么	HI
筤	HIAV
??	HIBJJ
簠	HIBT
魍	HIBTV
??	HIDD
魈	HIFB
鵝	HIHAF
鬿	HIHML
犩	HIHQ
箴	HIHR
箋	HII
篸	HIIH
魃	HIIKK
魊	HIIRM
??	HIIT
魆	HIIV
??	HIJC
魅	HIJD
鬾	HIJE
??	HILE
魎	HIMLB
魒	HIMWF
乏	HINO
魋	HIOG
??	HIOLL
笞	HIR
笲	HIT
簾	HITC
魌	HITMC
??	HITWI
??	HITXC
魕	HIVII
??	HIWTJ
簏	HIXP
魁	HIYJ
魖	HIYPM
??	HIYU
魑	HIYUB
千	HJ
質	HJBC
盾	HJBU
箜	HJCM
朱	HJD
??	HJG
鵯	HJHAF
段	HJHNE
臿	HJHX
篿	HJII
??	HJIM
簳	HJJJ
簐	HJJO
??	HJJR
範	HJJU
箸	HJKA
箑	HJLO
乖	HJLP
顊	HJMBC
??	HJME
簆	HJMK
??	HJMM
筦	HJMU
郫	HJNL
??	HJP
舌	HJR
管	HJRR
翱	HJSMM
垂	HJTM
重	HJWG
夭	HK
昋	HKA
??	HKAB
簝	HKCF
棨	HKD
??	HKE
??	HKHAF
笅	HKK
??	HKL
蚕	HKLMI
肇	HKLQ
??	HKMN
??	HKNL
筴	HKOO
忝	HKP
吞	HKR
喬	HKRBR
竻	HKS
笳	HKSR
??	HKU
綮	HKVIF
譥	HKYMR
齃	HLAPV
禹	HLBI
質	HLBUC
??	HLD
??	HLHUK
齉	HLJBV
鼽	HLKN
??	HLL
齂	HLLE
簰	HLLJ
??	HLLL
劓	HLLN
簍	HLLV
頎	HLMBC
簣	HLMC
鼾	HLMJ
禦	HLMMF
筄	HLMO
齀	HLMVN
欣	HLNO
爪	HLO
齁	HLPR
筆	HLQ
齈	HLTWV
籔	HLVK
齆	HLVVU
笛	HLW
斶	HLWLI
簫	HLX
笫	HLXH
齇	HLYPM
笁	HM
??	HMAU
篢	HMBC
籗	HMBG
??	HMBO
眚	HMBU
??	HMC
竽	HMD
箌	HMGN
筭	HMGT
鴟	HMHAF
??	HMHMM
筑	HMHN
毀	HMHNE
甡	HMHQM
竿	HMJ
笄	HMJJ
??	HMJK
??	HMJR
斤	HML
竺	HMM
??	HMMP
??	HMMS
笎	HMMU
甀	HMMVN
築	HMND
??	HMNJ
郵	HMNL
篫	HMNQ
笴	HMNR
筮	HMOO
??	HMP
后	HMR
??	HMRN
筇	HMSL
歸	HMSMB
卮	HMSU
笄	HMT
簪	HMUA
篥	HMWD
篻	HMWF
簟	HMWJ
甥	HMWKS
斥	HMY
几	HN
颺	HNAMH
颶	HNBMC
??	HNC
簷	HNCR
朵	HND
箛	HNDO
殳	HNE
篜	HNEF
颾	HNEII
??	HNF
??	HNFB
飆	HNFFF
凰	HNHAG
笈	HNHE
颩	HNHHH
飀	HNHHW
颳	HNHJR
風	HNHLI
??	HNHNI
??	HNHNN
犁	HNHQ
颼	HNHXE
凡	HNI
筩	HNIB
颱	HNIR
飉	HNKCF
筳	HNKG
??	HNKK
筵	HNKM
篨	HNLD
第	HNLH
鳳	HNMAF
飋	HNMGH
颳	HNMJR
??	HNMLB
風	HNMLI
篛	HNMM
夙	HNMNI
颲	HNMNN
颬	HNMVH
??	HNMWF
??	HNONO
??	HNOP
簦	HNOT
愆	HNP
颮	HNPRU
掣	HNQ
??	HNQKI
躗	HNRYO
飂	HNSMH
颸	HNWP
製	HNYHV
讆	HNYMR
颭	HNYR
八	HO
昝	HOA
得	HOAMI
徥	HOAMO
爬	HOAU
忁	HOAUE
很	HOAV
??	HOB
籲	HOBC
篧	HOBG
衢	HOBGN
徟	HOBGR
徂	HOBM
徭	HOBOU
??	HOBQR
衕	HOBRN
??	HOBUG
徯	HOBVK
彸	HOCI
銜	HOCMN
衛	HODBN
彼	HODHE
符	HODI
徫	HODMQ
徠	HODOO
衛	HODQN
??	HODWF
衍	HOEMN
熧	HOF
徶	HOFBK
徜	HOFBR
??	HOFBV
??	HOG
待	HOGDI
街	HOGGN
??	HOGGU
??	HOGTJ
徒	HOGYO
鴔	HOHAF
徨	HOHAG
衝	HOHGN
循	HOHJU
??	HOHK
役	HOHNE
彽	HOHPM
瓞	HOHQO
遍	HOHSB
徼	HOHSK
??	HOHT
筏	HOI
??	HOIB
術	HOICN
笭	HOII
籤	HOIM
笒	HOIN
??	HOIR
??	HOJE
??	HOJJN
??	HOJJV
徖	HOJMF
衚	HOJRN
德	HOJWP
徛	HOKMR
劮	HOKS
??	HOL
篠	HOLD
瓥	HOLII
筱	HOLK
??	HOLLL
彿	HOLLN
徘	HOLMY
??	HOLPC
律	HOLQ
籥	HOMB
徆	HOMCW
筡	HOMD
筌	HOMG
衎	HOMJN
箯	HOMK
行	HOMMN
簽	HOMO
答	HOMR
衙	HOMRN
??	HOMUN
徑	HOMVM
征	HOMYM
??	HONBN
??	HONFN
彶	HONHE
篌	HONK
衡	HONKN
復	HOOAE
彾	HOOII
徻	HOOMA
徐	HOOMD
御	HOOML
??	HOOO
從	HOOOO
筰	HOOS
慫	HOP
徇	HOPA
彴	HOPI
??	HOPM
瓟	HOPRU
篟	HOQB
咎	HOR
??	HORN
??	HORRK
徦	HORSE
笮	HOS
徲	HOSEQ
聳	HOSJ
??	HOSJL
??	HOSSN
??	HOSU
??	HOTC
衖	HOTCN
??	HOTIO
徉	HOTQ
??	HOTUN
徽	HOUFK
徵	HOUGK
徾	HOURK
微	HOUUK
後	HOVIE
徊	HOWR
徹	HOYBK
徿	HOYBP
徬	HOYBS
往	HOYG
彷	HOYHS
衒	HOYIN
斞	HOYJ
徙	HOYLO
忀	HOYRV
乇	HP
昏	HPA
??	HPD
筷	HPDK
鵖	HPHAF
笏	HPHH
??	HPIM
??	HPLB
剩	HPLN
氐	HPM
??	HPMBC
笉	HPMM
鄎	HPNL
笓	HPP
笱	HPR
笣	HPRU
印	HPSL
??	HPT
篘	HPUU
??	HPW
牛	HQ
犦	HQATE
犋	HQBMC
犅	HQBTU
看	HQBU
犑	HQBUK
??	HQD
籍	HQDA
犈	HQFQU
牡	HQG
特	HQGDI
犢	HQGWC
犐	HQHDJ
牿	HQHGR
??	HQHJ
犞	HQHKB
牴	HQHPM
牪	HQHQ
牲	HQHQM
??	HQHQQ
??	HQHQR
籀	HQHW
我	HQI
犥	HQIPF
牻	HQIUH
犆	HQJBM
篲	HQJM
牸	HQJND
犗	HQJQR
牯	HQJR
??	HQJWJ
??	HQKD
??	HQKE
犄	HQKMR
牞	HQKS
牰	HQLW
牬	HQLXH
生	HQM
箐	HQMB
簀	HQMC
??	HQMCW
牾	HQMMR
拜	HQMQJ
??	HQMR
犡	HQMTB
牼	HQMVM
觕	HQNBG
犍	HQNKQ
邦	HQNL
失	HQO
??	HQOA
牧	HQOK
牷	HQOMG
??	HQOMR
??	HQOND
??	HQORQ
??	HQOWY
牝	HQP
牠	HQPD
物	HQPHH
犓	HQPUU
筘	HQR
犌	HQRSE
箍	HQSB
牣	HQSHI
簎	HQTA
簼	HQTB
犪	HQTCE
犧	HQTGS
犕	HQTHB
箝	HQTM
毛	HQU
犣	HQVVV
籜	HQWJ
犤	HQWLP
牳	HQWYI
犒	HQYRB
犉	HQYRD
犝	HQYTG
篔	HRBC
??	HRD
??	HRE
舕	HRFF
垕	HRG
舑	HRGB
鵠	HRHAF
舔	HRHKP
舐	HRHPM
筥	HRHR
舐	HRHVP
阜	HRJ
勂	HRKS
帥	HRLB
蛗	HRLMI
刮	HRLN
頧	HRMBC
舔	HRMKP
師	HRMLB
簬	HRMR
郜	HRNL
雒	HROG
啟	HROK
??	HRP
簞	HRRJ
??	HRRR
??	HRSE
甜	HRTM
峊	HRU
簨	HRUC
笢	HRVP
??	HRYE
烏	HRYF
戶	HS
肩	HSB
扃	HSBR
扁	HSBT
勳	HSF
扊	HSFF
??	HSHAF
所	HSHML
殷	HSHNE
笤	HSHR
戾	HSIK
籃	HSIT
筍	HSK
篋	HSKO
??	HSLB
??	HSLC
扉	HSLMY
篚	HSLY
帚	HSMB
??	HSMBC
筐	HSMG
笥	HSMR
籃	HSMT
??	HSN
??	HSNIN
雇	HSOG
敫	HSOK
篤	HSQF
??	HSR
扈	HSRAU
戺	HSRU
扇	HSSMM
??	HSSU
??	HSTT
房	HSYHS
扆	HSYHV
戽	HSYJ
扂	HSYR
升	HT
箭	HTBN
簸	HTCE
??	HTCF
簊	HTCG
??	HTCO
??	HTFQ
??	HTG
鷑	HTHAF
眾	HTHHO
??	HTHHV
箬	HTKR
簧	HTLC
箕	HTMC
衃	HTMF
衄	HTNG
??	HTNO
憩	HTP
??	HTSHI
衈	HTSJ
卹	HTSL
篝	HTTB
衊	HTTWI
??	HUB
贊	HUBUC
臬	HUD
皋	HUEJ
??	HUF
毯	HUFF
鶂	HUHAF
毨	HUHGU
??	HUHHH
毳	HUHUU
鬼	HUI
毧	HUIJ
毬	HUIJE
臭	HUIK
瞂	HUIKK
穨	HULMC
??	HULMY
頹	HUMBC
毢	HUMCW
??	HUMR
毽	HUNKQ
郳	HUNL
歋	HUNO
氌	HUNWA
臮	HUOOO
息	HUP
氁	HUTAK
氆	HUTCA
氆	HUTMA
??	HUU
鼻	HUWML
毸	HUWP
鼻	HUWT
氈	HUYR
罪	HUYTJ
毰	HUYTR
??	HVAJV
鼲	HVBJJ
鼰	HVBUC
鼳	HVBUK
覛	HVBUU
鼷	HVBVK
鼢	HVCSH
笯	HVE
??	HVFG
箹	HVFI
鼭	HVGDI
鼨	HVHEY
鼪	HVHQM
兜	HVHU
魏	HVHUI
鼶	HVHYU
系	HVIF
鼣	HVIK
鼥	HVIKK
籪	HVIL
瓜	HVIO
鼵	HVJCK
鼬	HVLW
鼯	HVMMR
鼫	HVMR
瓾	HVMVN
鼮	HVNKG
篆	HVNO
氏	HVP
鼩	HVPR
鼱	HVQMB
筎	HVR
鼴	HVSAV
卬	HVSL
鼸	HVTXC
鼤	HVYK
??	HWBUT
??	HWCSH
笝	HWE
睾	HWGTJ
鷭	HWHAF
箘	HWHD
卑	HWHJ
??	HWHXH
簂	HWIM
箇	HWJR
囟	HWK
囪	HWKK
勫	HWKS
笚	HWL
??	HWLB
??	HWLC
籮	HWLG
??	HWLH
篾	HWLI
??	HWLL
箅	HWML
粵	HWMVS
囪	HWNI
鄱	HWNL
飛	HWNOO
匆	HWP
翻	HWSMM
篳	HWTJ
臼	HX
興	HXBC
盥	HXBT
??	HXG
身	HXH
兒	HXHU
輿	HXJC
帠	HXLB
叟	HXLE
??	HXLS
??	HXM
歃	HXNO
臾	HXO
舁	HXT
鼠	HXVYV
舅	HXWKS
與	HXYC
舄	HXYF
昝	HYA
艒	HYABU
舥	HYAU
簻	HYBB
籬	HYBG
艀	HYBND
籠	HYBP
篣	HYBS
??	HYCI
筊	HYCK
船	HYCR
艄	HYFB
艡	HYFBW
??	HYFF
??	HYGOW
舶	HYHA
鵃	HYHAF
艎	HYHAG
舨	HYHE
艂	HYHEJ
舽	HYHEQ
篷	HYHJ
艞	HYHLO
簅	HYHM
笐	HYHN
般	HYHNE
??	HYHNI
船	HYHNR
簉	HYHR
籩	HYHS
艑	HYHSB
艘	HYHXE
??	HYJMO
舵	HYJP
簅	HYKM
舿	HYKMS
??	HYKOO
艜	HYKPB
舯	HYL
螽	HYLII
艛	HYLLV
舳	HYLW
舡	HYM
舸	HYMNR
篴	HYMO
籯	HYNC
艋	HYNDT
艇	HYNKG
艬	HYNRI
??	HYNV
艭	HYOGE
舲	HYOII
??	HYOIP
艙	HYOIR
箤	HYOJ
艅	HYOMD
舴	HYOS
??	HYPC
籚	HYPT
艓	HYPTD
虒	HYPU
咎	HYR
篙	HYRB
??	HYRJI
篰	HYRL
籇	HYRO
??	HYSC
箷	HYSD
舠	HYSH
艉	HYSHU
艦	HYSIT
簇	HYSK
艦	HYSMT
??	HYSO
箊	HYSY
笠	HYT
艨	HYTBO
舼	HYTC
艗	HYTCT
艤	HYTGI
艏	HYTHU
艖	HYTQM
??	HYTRG
艚	HYTWA
舢	HYU
篱	HYUB
艐	HYUCE
??	HYUU
笀	HYV
舺	HYWL
簑	HYWV
艕	HYYBS
航	HYYHN
舫	HYYHS
籧	HYYO
艣	HYYPS
艫	HYYPT
艟	HYYTG
舷	HYYVI
艩	HYYX
戈	I
廄	IAIE
廄	IAIU
良	IAV
禸	IB
??	IBBT
廁	IBCN
廮	IBCV
尃	IBDI
塱	IBG
鵏	IBHAF
郙	IBNL
能	IBPP
??	IBT
??	IBUC
??	IBYHS
??	ICA
??	ICAPH
??	ICBBB
??	ICDA
??	ICDD
糜	ICFD
??	ICG
穈	ICHD
??	ICHDA
麼	ICHI
??	ICHQ
麾	ICHQU
魔	ICHUI
??	ICID
黂	ICJTC
靡	ICLMY
磨	ICMR
鄺	ICNL
廞	ICNO
??	ICOA
怷	ICP
摩	ICQ
??	ICRHR
??	ICRXU
黀	ICSJE
麼	ICVI
??	ICVIF
??	ICWA
床	ID
廂	IDBU
麻	IDD
糜	IDFD
塺	IDG
穈	IDHD
??	IDHDA
麼	IDHI
犘	IDHQ
麾	IDHQU
魔	IDHUI
黂	IDJTC
靡	IDLMY
磨	IDMR
庲	IDOO
摩	IDQ
??	IDRHR
黀	IDSJE
麼	IDVI
縻	IDVIF
冰	IE
昶	IEA
盚	IEBT
皴	IEDHE
??	IEHAF
剫	IELN
??	IEMBC
救	IEOK
裘	IEYHV
??	IFAA
禓	IFAMH
禔	IFAMO
??	IFAOC
??	IFAPH
禢	IFASM
??	IFAUM
禍	IFBBR
禂	IFBGR
禈	IFBJJ
廠	IFBK
祖	IFBM
禐	IFBME
??	IFBQR
視	IFBUU
??	IFCB
??	IFCNH
??	IFD
禕	IFDMQ
禷	IFFKC
社	IFG
祛	IFGI
禱	IFGNI
禧	IFGRR
??	IFHA
鷓	IFHAF
??	IFHER
祰	IFHGR
祩	IFHJD
祅	IFHK
祈	IFHML
??	IFHN
祋	IFHNE
祗	IFHPM
祑	IFHQO
??	IFHQR
??	IFHSR
??	IFHTC
禶	IFHUC
祇	IFHVP
??	IFHWJ
禠	IFHYU
??	IFIJE
祓	IFIKK
??	IFILR
祴	IFIT
??	IFIUM
禛	IFJBC
??	IFJBJ
??	IFJD
??	IFJII
??	IFJKA
??	IFJKP
祜	IFJR
??	IFKOO
祐	IFKR
祌	IFL
??	IFLE
祧	IFLMO
??	IFLPB
??	IFLPC
神	IFLWL
顣	IFMBC
禰	IFMFB
??	IFMG
??	IFMIG
祆	IFMK
??	IFMMF
祳	IFMMV
祏	IFMR
福	IFMRW
禲	IFMTB
禋	IFMWG
禫	IFMWJ
礽	IFNHS
祁	IFNL
祪	IFNMU
祔	IFODI
??	IFOG
祣	IFOHV
??	IFOII
??	IFOIN
??	IFOKS
祄	IFOLL
禬	IFOMA
禴	IFOMB
祫	IFOMR
祚	IFOS
憑	IFP
祂	IFPD
祕	IFPH
礿	IFPI
??	IFPM
??	IFPMM
祹	IFPOU
??	IFQC
禊	IFQHK
??	IFRBC
祝	IFRHU
禪	IFRRJ
祀	IFRU
??	IFRVK
蹙	IFRYO
祒	IFSHR
??	IFSJR
祲	IFSME
祤	IFSMM
祠	IFSMR
禡	IFSQF
祀	IFSU
??	IFTCW
禚	IFTGF
祺	IFTMC
禖	IFTMD
祥	IFTQ
禮	IFTWT
??	IFTWV
禨	IFVII
祿	IFVNE
禒	IFVNO
??	IFWCE
祼	IFWD
禤	IFWLM
禗	IFWP
??	IFWTC
禘	IFYBB
禎	IFYBC
祊	IFYHS
祉	IFYLM
祽	IFYOJ
禳	IFYRV
禭	IFYTO
庄	IG
庱	IGCE
庤	IGDI
??	IGI
廅	IGIT
廧	IGOW
廒	IGSK
廚	IGTI
戊	IH
??	IHBT
毿	IHHQU
廇	IHHW
戍	IHI
螷	IHJI
剼	IHLN
戌	IHM
??	IHMF
庍	IHML
咸	IHMR
威	IHMV
??	IHN
廄	IHPE
底	IHPM
牟	IHQ
成	IHS
??	IHSLL
允	IHU
廆	IHUI
庳	IHWJ
廋	IHXE
庾	IHXO
戚	IHYMF
戔	II
朗	IIB
盞	IIBT
??	IIBYJ
絫	IIIF
參	IIIH
廊	IIIL
??	IIIM
??	IIIP
剷	IILN
疒	IIM
郎	IINL
欴	IINO
??	IISL
庬	IIUH
廘	IIXP
戎	IJ
甫	IJB
朮	IJC
麻	IJCC
??	IJCN
求	IJE
廟	IJJB
庨	IJKD
庫	IJWJ
犬	IK
貵	IKBUC
??	IKC
參	IKHHH
飆	IKHNI
??	IKI
猋	IKIKK
軬	IKJWJ
犮	IKK
庵	IKLU
??	IKMMM
為	IKNF
欸	IKNO
慦	IKP
廗	IKPB
彧	IKRM
尤	IKU
畚	IKW
庸	ILB
康	ILE
州	ILIL
??	ILL
廔	ILLV
庣	ILMO
??	ILMY
划	ILN
庚	ILO
??	ILOB
賡	ILOC
??	ILOF
唐	ILR
??	ILW
冫	IM
??	IMAA
??	IMAYT
凋	IMBGR
??	IMBQR
凈	IMBSD
凎	IMC
??	IMCSH
庮	IMCW
決	IMDK
??	IMDL
凍	IMDW
冰	IME
??	IMFQ
凌	IMGCE
??	IMGDE
??	IMHAF
冼	IMHGU
??	IMHK
庢	IMIG
??	IMIHR
??	IMIHS
冹	IMIKK
??	IMINE
冶	IMIR
凄	IMJLV
??	IMJWJ
沖	IML
凞	IMLSF
??	IMLWL
??	IMM
??	IMMBI
冽	IMMNN
廲	IMMP
??	IMMVH
冱	IMMVM
??	IMMWD
凐	IMMWG
次	IMNO
准	IMOG
??	IMOGF
冷	IMOII
凔	IMOIR
??	IMOIV
涂	IMOMD
??	IMOMN
冾	IMOMR
??	IMOMV
惑	IMP
凝	IMPKO
湊	IMQKK
凊	IMQMB
況	IMRHU
??	IMSHR
臧	IMSLL
馮	IMSQF
凘	IMTCL
??	IMTKN
廈	IMUE
凗	IMUOG
庌	IMVH
??	IMWG
凅	IMWJR
??	IMYBC
??	IMYK
??	IMYMY
涼	IMYRF
??	IMYRN
凜	IMYWD
廨	INBQ
永	INE
廯	INFQ
序	ININ
庭	INKG
廕	INLI
之	INO
廢	INOE
庂	IO
盜	IOBT
資	IOBUC
??	IOC
庥	IOD
府	IODI
粢	IOFD
??	IOG
膺	IOGB
鷹	IOGF
應	IOGP
??	IOGR
鶊	IOHAF
秶	IOHD
腐	IOIB
??	IOIF
庈	IOIN
矣	IOK
廥	IOMA
瓷	IOMVN
座	IOOG
餈	IOOIV
??	IOOJU
恣	IOP
咨	IOR
楶	IORD
廡	IOTF
姿	IOV
??	IOYT
弋	IP
麆	IPBM
貣	IPBUC
鏖	IPC
??	IPCOR
熊	IPF
麋	IPFD
麟	IPFDQ
塵	IPG
??	IPHAF
麇	IPHD
??	IPHDA
??	IPHER
麝	IPHHI
麂	IPHN
麔	IPHOR
??	IPHS
麑	IPHXU
??	IPHYR
??	IPI
麙	IPIHR
麤	IPIPP
??	IPKSR
螚	IPLMI
式	IPM
??	IPMBR
??	IPMBT
廎	IPMC
??	IPMM
貳	IPMMC
??	IPMMM
麎	IPMMV
麜	IPMWD
麠	IPMWM
鄜	IPNL
麛	IPNSJ
隿	IPOG
態	IPP
??	IPPRU
??	IPRRK
麚	IPRSE
庖	IPRU
麌	IPRVK
??	IPSJ
麒	IPTMC
庉	IPU
??	IPW
麇	IPWHD
??	IPWMM
麈	IPYG
麍	IPYIU
??	IPYKR
??	IPYTJ
??	IPYUB
麡	IPYX
鴾	IQHAF
緳	IQHF
庪	IQJE
台	IR
枲	IRD
炱	IRF
鶶	IRHAF
或	IRM
顑	IRMBC
瓵	IRMVN
觱	IRNBG
邰	IRNL
感	IRP
??	IRU
??	IRYTJ
盛	ISBT
廳	ISGP
廜	ISJA
廖	ISMH
郕	ISNL
敷	ISOK
廦	ISRJ
戒	IT
庴	ITA
廝	ITCL
度	ITE
庶	ITF
鴘	ITHAF
席	ITLB
廣	ITLC
廑	ITLM
??	ITNH
庠	ITQ
??	ITS
庹	ITSO
庰	ITT
廉	ITXC
尨	IUHHH
戉	IV
??	IVMBC
??	IVRAU
廱	IVUG
廛	IWCG
??	IWF
??	IWLB
廩	IWRF
廙	IWTC
慶	IXE
廌	IXF
鹿	IXP
龐	IYBP
廓	IYDL
爢	IYF
??	IYHU
??	IYLH
劘	IYLN
庛	IYMP
廬	IYPT
店	IYR
??	IYRL
廩	IYWD
十	J
睹	JABUU
煮	JAF
??	JAHNE
寔	JAMO
??	JAMV
都	JANL
翥	JASMM
宴	JAV
巿	JB
??	JBBM
??	JBBUC
寀	JBD
鶦	JBHAF
??	JBHF
櫜	JBHOD
獻	JBIK
宜	JBM
真	JBMC
直	JBMM
橐	JBMRD
蠹	JBMRI
孛	JBND
察	JBOF
囊	JBRRV
南	JBTJ
蟗	JBUUI
索	JBVIF
疐	JBWNO
穴	JC
??	JCAPP
窩	JCBBR
窯	JCBOU
窅	JCBU
??	JCD
??	JCEEE
窪	JCEGG
窏	JCEMD
??	JCESB
??	JCEYR
窲	JCFDJ
窾	JCGFO
窐	JCGG
灶	JCGRU
竇	JCGWC
窵	JCHAF
??	JCHD
竊	JCHDB
窸	JCHDP
窖	JCHGR
窌	JCHHL
窮	JCHHN
窆	JCHIO
穾	JCHK
窳	JCHOO
??	JCHQ
??	JCHQR
竅	JCHSK
竁	JCHUU
窊	JCHVO
窗	JCHWK
窗	JCHWN
??	JCHWP
竄	JCHXV
戭	JCI
??	JCID
??	JCIHS
突	JCIK
??	JCIP
窢	JCIRM
窴	JCJBC
窙	JCJKD
??	JCJR
??	JCKCF
究	JCKN
帘	JCLB
窶	JCLLV
窕	JCLMO
空	JCM
顛	JCMBC
穻	JCMD
窒	JCMIG
??	JCMJ
竀	JCMMU
窉	JCMOB
穿	JCMVH
穹	JCN
冤	JCNAI
窞	JCNHX
穸	JCNI
窿	JCNLM
歕	JCNO
??	JCOGS
窯	JCOJU
窱	JCOLD
??	JCOMC
窬	JCOMN
??	JCOMV
容	JCOR
窄	JCOS
??	JCPKO
窇	JCPRU
竊	JCPSH
窀	JCPU
窫	JCQHK
??	JCQMP
窺	JCQOU
??	JCRHU
??	JCSHX
窷	JCSJL
窘	JCSKR
翸	JCSMM
窟	JCSUU
窯	JCTGF
阱	JCTT
窋	JCUU
窈	JCVIS
窠	JCWD
??	JCWKP
??	JCWP
??	JCYAJ
??	JCYBP
窔	JCYCK
??	JCYMR
窣	JCYOJ
??	JCYRB
窨	JCYTA
未	JD
鵓	JDHAF
??	JDHNI
守	JDI
勃	JDKS
郣	JDNL
??	JDO
教	JDOK
??	JDSHI
支	JE
??	JEBUU
??	JEC
檕	JED
墼	JEG
麮	JEGI
??	JEGOW
鳷	JEHAF
麰	JEIHQ
??	JEIJB
轚	JEJWJ
蟿	JELMI
頍	JEMBC
麵	JEMLS
??	JEMR
麵	JEMWL
麵	JEMYS
罊	JEOJU
麧	JEON
麴	JEPFD
麭	JEPRU
擊	JEQ
麩	JEQO
寖	JESE
攳	JESMI
翅	JESMM
麴	JETW
麷	JEUJT
繫	JEVIF
麶	JEYUB
??	JF
宵	JFB
鶴	JGHAF
??	JGIK
??	JGTJ
??	JHD
審	JHDW
客	JHER
宎	JHK
冗	JHN
??	JHOK
寙	JHOO
宅	JHP
牢	JHQ
宒	JHQU
寫	JHXF
??	JHXU
博	JIBI
栽	JID
專	JIDI
??	JIF
鷒	JIHAF
??	JIHI
宬	JIHS
載	JIJWJ
寪	JIKF
蛓	JILMI
剸	JILN
??	JILSM
酨	JIMCW
臷	JIMIG
磚	JIMVN
鄟	JINL
胾	JIOBO
截	JIOG
惠	JIP
哉	JIR
??	JISMM
戴	JIWTC
裁	JIYHV
廾	JJ
轀	JJABT
??	JJAPH
輥	JJAPP
輵	JJAPV
朝	JJB
輣	JJBB
寘	JJBC
輖	JJBGR
??	JJBQR
輞	JJBTV
輍	JJCOR
韓	JJDMQ
輟	JJEEE
輎	JJFB
轔	JJFDQ
??	JJFMU
輘	JJGCE
轖	JJGOW
轅	JJGRV
輈	JJHBY
轓	JJHDW
輅	JJHER
軠	JJHG
??	JJHHK
輴	JJHJU
轎	JJHKB
斬	JJHML
軗	JJHNE
軓	JJHNI
軧	JJHPM
??	JJHQJ
軼	JJHQO
??	JJHQQ
軞	JJHQU
軶	JJHSN
軱	JJHVO
軝	JJHVP
輗	JJHXU
戟	JJI
輚	JJII
輔	JJIJB
軷	JJIKK
軾	JJIPM
軩	JJIR
轗	JJIRP
轆	JJIXP
??	JJJE
轉	JJJII
轟	JJJJJ
輐	JJJMU
轄	JJJQR
轒	JJJTC
軑	JJK
轑	JJKCF
軌	JJKN
軮	JJLBK
寁	JJLO
軸	JJLW
??	JJMBC
軟	JJMBK
輀	JJMBL
軯	JJMFJ
??	JJMG
轣	JJMHM
輊	JJMIG
軒	JJMJ
輛	JJMLB
轉	JJMMI
軻	JJMNR
??	JJMPM
輻	JJMRW
軛	JJMSU
軏	JJMU
輕	JJMVM
輓	JJNAU
??	JJNDT
輮	JJNHD
軟	JJNO
??	JJNST
輹	JJOAE
軜	JJOB
榦	JJOD
軵	JJODI
鶾	JJOHF
軫	JJOHH
軨	JJOII
軡	JJOIN
螒	JJOLI
輪	JJOMB
輇	JJOMG
幹	JJOMJ
輸	JJOMN
輸	JJOMV
乾	JJON
雗	JJOOG
翰	JJOSM
斡	JJOYJ
軥	JJPR
軘	JJPU
輷	JJPYR
??	JJQJM
轃	JJQKD
輳	JJQKK
輤	JJQMB
軹	JJRC
軦	JJRHU
輯	JJRSJ
軔	JJSHI
軺	JJSHR
轞	JJSIT
輒	JJSJE
輒	JJSJU
軔	JJSK
輑	JJSKR
轇	JJSMH
轞	JJSMT
轏	JJSND
輾	JJSTV
轕	JJTAV
輁	JJTC
轐	JJTCO
輶	JJTCW
轙	JJTGI
軿	JJTT
軋	JJU
輲	JJUMB
轢	JJVID
轈	JJVVD
輜	JJVVW
輠	JJWD
轘	JJWLV
轀	JJWOT
轠	JJWWW
轍	JJYBK
??	JJYCB
較	JJYCK
??	JJYE
軴	JJYG
轋	JJYJJ
轤	JJYPT
輬	JJYRF
輆	JJYVO
丈	JK
者	JKA
宥	JKB
寮	JKCF
??	JKCU
鶟	JKHAF
宏	JKI
斄	JKMDO
漦	JKME
犛	JKMHQ
氂	JKMHU
孷	JKMND
寄	JKMR
剺	JKMSH
嫠	JKMV
考	JKMVS
釐	JKMWG
宄	JKN
孝	JKND
老	JKP
耇	JKPR
??	JKSR
協	JKSS
考	JKYS
暫	JLA
鏨	JLC
槧	JLD
塹	JLG
衷	JLHV
吏	JLK
事	JLLN
寠	JLLV
宨	JLMO
磛	JLMR
??	JLP
??	JLR
蹔	JLRYO
妻	JLV
宙	JLW
疌	JLYO
士	JM
宣	JMAM
鑋	JMC
寡	JMCH
宇	JMD
賓	JMHC
室	JMIG
??	JMII
矗	JMJMM
??	JMK
寅	JMLC
賨	JMMC
宗	JMMF
??	JMMN
完	JMMU
宸	JMMV
宁	JMN
??	JMP
宕	JMR
富	JMRW
??	JMSMM
家	JMSO
寶	JMUC
寇	JMUE
定	JMYO
冤	JNAI
字	JND
鸋	JNHAF
宛	JNIU
剚	JNLN
惌	JNUP
??	JOG
??	JOGG
寯	JOGS
宿	JOMA
顁	JOMBC
??	JOMC
麥	JONI
寑	JOSE
它	JP
耆	JPA
寧	JPBN
甯	JPBQ
寍	JPBT
??	JPGB
宓	JPH
蜜	JPHI
耄	JPHQU
密	JPHU
寲	JPKO
耋	JPMIG
??	JPPR
??	JPU
害	JQJR
??	JQMB
憲	JQMP
害	JQMR
古	JR
胡	JRB
鶘	JRBHF
豁	JRCOR
??	JRFBG
??	JRFMU
鴣	JRHAF
??	JRHHH
毄	JRHNE
宮	JRHR
克	JRHU
割	JRLN
官	JRLR
額	JRMBC
故	JROK
悹	JRRP
嘏	JRRSE
辜	JRYTJ
冤	JSHI
宭	JSKR
宦	JSLL
寥	JSMH
卉	JT
寞	JTAK
賁	JTBC
寬	JTBI
賽	JTCC
寨	JTCD
??	JTCE
騫	JTCF
塞	JTCG
蹇	JTCO
搴	JTCQ
謇	JTCR
寋	JTCU
褰	JTCV
寒	JTCY
鼖	JTGE
??	JTGF
七	JU
兝	JUCSH
剋	JUDI
鵷	JUHAF
兛	JUHJ
兞	JUHQU
兙	JUJ
兢	JUJRU
勀	JUKS
剜	JULN
兡	JUMA
兣	JUMWG
安	JV
案	JVD
??	JVG
鶈	JVHAF
寎	JVMB
頞	JVMBC
寐	JVMD
寢	JVME
寤	JVMR
郪	JVNL
??	JVTJ
覾	JWBUU
車	JWJ
實	JWJC
??	JWJE
寓	JWLB
寰	JWLV
??	JWP
??	JYAJ
寊	JYBC
寵	JYBP
寂	JYFE
??	JYLC
宰	JYTJ
大	K
瘟	KABT
疸	KAM
瘍	KAMH
癇	KANB
奲	KARRJ
疤	KAU
痕	KAV
有	KB
痭	KBB
瘑	KBBR
癭	KBCV
??	KBD
鵗	KBHAF
殽	KBHNE
毻	KBHQU
??	KBIHS
戫	KBIRM
疽	KBM
痌	KBMR
瓻	KBMVN
郗	KBNL
欷	KBNO
瘵	KBOF
??	KBUG
??	KBY
閷	KCANO
殺	KCHNE
弒	KCIPM
剎	KCLN
??	KDANO
痳	KDD
疲	KDHE
殺	KDHNE
弒	KDIPM
癩	KDLC
剎	KDLN
??	KDLO
友	KE
痧	KEFH
瘙	KEII
奫	KELL
??	KEP
灰	KF
痟	KFB
盔	KFBT
瘠	KFCB
痰	KFF
癆	KFFS
鷯	KFHAF
??	KFNRU
悐	KFP
??	KG
痔	KGDI
奎	KGG
鵟	KGHAF
痣	KGP
猖	KHAA
猩	KHAHM
癤	KHAL
狚	KHAM
??	KHAMJ
猑	KHAPP
猲	KHAPV
狠	KHAV
獌	KHAWE
猾	KHBBB
猧	KHBBR
狙	KHBM
??	KHBME
狪	KHBMR
痸	KHBN
猺	KHBOU
猙	KHBSD
狦	KHBTT
狽	KHBUC
玃	KHBUE
癪	KHDC
痵	KHDD
??	KHDH
獺	KHDLC
痢	KHDN
痿	KHDV
猀	KHEFH
疼	KHEY
狄	KHF
獙	KHFBK
獟	KHGGU
狤	KHGR
猿	KHGRV
??	KHHAM
猘	KHHBN
??	KHHDF
猁	KHHDN
狅	KHHG
獯	KHHGF
獢	KHHKB
奅	KHHL
猦	KHHNI
狌	KHHQM
獅	KHHRB
猵	KHHSB
獥	KHHSK
狐	KHHVO
瘤	KHHW
猈	KHHWJ
獀	KHHXE
獡	KHHXF
猊	KHHXU
狼	KHIAV
猼	KHIBI
狻	KHICE
狁	KHIHU
狨	KHIJ
疺	KHIO
獷	KHITC
??	KHIUH
狘	KHIV
狖	KHJC
狩	KHJDI
??	KHJG
獑	KHJJL
豬	KHJKA
狫	KHJKP
獰	KHJPN
狜	KHJR
猢	KHJRB
獠	KHKCF
狶	KHKKB
猗	KHKMR
犰	KHKN
狹	KHKOO
狆	KHL
狒	KHLLN
狣	KHLMO
狟	KHMAM
獳	KHMBB
獶	KHMBE
獿	KHMCE
??	KHMCW
獮	KHMFB
狉	KHMFM
狂	KHMG
??	KHMGT
獂	KHMHF
犴	KHMJ
狋	KHMMF
獗	KHMTO
犽	KHMVH
獬	KHNBQ
猻	KHNDF
猛	KHNDT
疫	KHNE
狃	KHNG
峱	KHNGU
獝	KHNHB
猱	KHNHD
瘋	KHNI
狿	KHNKM
獼	KHNMB
狑	KHOII
獊	KHOIR
癥	KHOK
獪	KHOMA
狳	KHOMD
獫	KHOMO
猞	KHOMR
犵	KHON
猴	KHONK
瘲	KHOO
??	KHOPD
瘩	KHOR
??	KHPA
狴	KHPPG
狗	KHPR
猰	KHQHK
狾	KHQHL
??	KHQKA
獉	KHQKD
猜	KHQMB
狷	KHRB
玁	KHRRK
猳	KHRSE
狔	KHSP
犯	KHSU
??	KHTAK
獦	KHTAV
獛	KHTCO
??	KHTCT
猶	KHTCW
玂	KHTJL
獚	KHTLC
獲	KHTOE
獾	KHTRG
??	KHTUI
貓	KHTW
癟	KHUB
猣	KHUCE
瘣	KHUI
??	KHUMR
瘜	KHUP
猭	KHVNO
疧	KHVP
獵	KHVVV
猓	KHWD
狸	KHWG
痺	KHWJ
狎	KHWL
玀	KHWLG
獨	KHWLI
獧	KHWLV
猥	KHWMV
瘦	KHXE
瘐	KHXO
癙	KHXV
狡	KHYCK
瘢	KHYE
犺	KHYHN
獩	KHYMH
狺	KHYMR
猝	KHYOJ
??	KHYPN
猇	KHYPU
獄	KHYRK
獽	KHYRV
獞	KHYTG
獐	KHYTJ
??	KHYTP
獍	KHYTU
犿	KHYY
太	KI
痠	KICE
痡	KIJB
疣	KIKU
??	KINL
雄	KIOG
翃	KISMM
??	KITGI
痝	KIUH
奿	KIV
瘨	KJBC
癲	KJCC
奢	KJKA
痚	KJKD
痯	KJRR
奔	KJT
爻	KK
肴	KKB
療	KKCF
鷞	KKHAF
爽	KKKK
希	KKLB
痷	KKLU
痍	KKN
瘞	KKOG
瘱	KKOP
瘸	KKRB
夯	KKS
痂	KKSR
布	KLB
在	KLG
??	KLKP
夼	KLLL
疿	KLLN
??	KLLV
痋	KLMI
痱	KLMY
刈	KLN
存	KLND
奄	KLWU
左	KM
奭	KMAA
癗	KMBW
痞	KMFR
??	KMHM
??	KMJS
??	KMLM
奈	KMMF
痦	KMMR
夸	KMMS
疔	KMN
奇	KMNR
病	KMOB
痘	KMRT
??	KMSKR
瘃	KMSO
痙	KMVM
瘭	KMWF
症	KMYM
九	KN
旭	KNA
瘓	KNBK
癚	KNCR
??	KNF
癬	KNFQ
鳩	KNHAF
丸	KNI
痛	KNIB
奓	KNIN
??	KNJMJ
癃	KNLM
癮	KNLP
痾	KNLR
頄	KNMBC
疚	KNO
癈	KNOE
??	KNR
??	KNSV
馗	KNTHU
??	KNV
訄	KNYMR
虓	KNYPU
??	KOBUC
痽	KOG
奪	KOGI
奮	KOGW
鵊	KOHAF
疹	KOHH
瘡	KOIR
疾	KOK
痴	KOKR
疥	KOLL
癐	KOMA
頰	KOMBC
痊	KOMG
瘉	KOMN
癒	KOMP
??	KOMV
疙	KON
瘊	KONK
郟	KONL
夾	KOO
痤	KOOG
痄	KOS
痗	KOWY
疕	KP
帶	KPBLB
癡	KPKO
疪	KPP
痀	KPR
疶	KPT
瘈	KQHK
瘛	KQHP
右	KR
賀	KRBUC
疻	KRC
架	KRD
鵸	KRHAF
毠	KRHQU
攲	KRJE
剞	KRLN
哿	KRMNR
欹	KRNO
??	KROJU
嗧	KROMB
癉	KRRJ
癌	KRRU
瘕	KRSE
駕	KRSQF
??	KRV
敧	KRYE
袈	KRYHV
力	KS
癜	KSCE
鴮	KSHAF
綔	KSHVF
瓠	KSHVO
耷	KSJ
脅	KSKSB
劦	KSKSS
姭	KSKSV
刳	KSLN
瘺	KSMB
瘳	KSMH
套	KSMI
??	KSMWG
??	KSNL
匏	KSPRU
加	KSR
癖	KSRJ
奩	KSRR
??	KSWL
勰	KSWP
??	KTA
瘼	KTAK
痶	KTBC
瘔	KTJR
瘽	KTLM
疳	KTM
癱	KTOG
瘩	KTOR
癢	KTOV
癢	KTQ
瘥	KTQM
瘚	KTUO
癘	KTWB
??	KTWV
疝	KU
尳	KUBBB
鵪	KUHAF
尰	KUHJG
尪	KUMG
尬	KUOLL
尥	KUPI
??	KUPM
尷	KUSIT
尷	KUSMT
??	KUTXC
癵	KVFB
癰	KVUG
痼	KWJR
瘝	KWLE
??	KWLV
痹	KWML
瘟	KWOT
痐	KWR
瘰	KWVF
??	KWWF
疰	KYG
疵	KYMP
瘁	KYOJ
瘧	KYPM
痁	KYR
瘯	KYSK
瘀	KYSY
瘖	KYTA
瘴	KYTJ
痎	KYVO
癠	KYX
中	L
衵	LA
裮	LAA
??	LABT
袒	LAM
褆	LAMO
襉	LANB
襴	LANW
裼	LAPH
??	LAPP
褐	LAPV
褟	LASM
襮	LATE
裉	LAV
巾	LB
帽	LBABU
幌	LBAFU
帊	LBAU
幔	LBAWE
幜	LBAYF
幎	LBBAC
??	LBBE
幍	LBBHX
帨	LBCRU
帔	LBDHE
幃	LBDMQ
帩	LBFB
幬	LBGNI
裯	LBGR
帕	LBHA
幯	LBHAL
??	LBHBI
幡	LBHDW
帆	LBHNI
帙	LBHQO
幮	LBIGI
帴	LBII
幓	LBIIH
帗	LBIKK
褌	LBJJ
帾	LBJKA
幏	LBJMO
幰	LBJQP
幩	LBJTC
央	LBK
帎	LBLBU
袓	LBM
幁	LBMBC
褑	LBME
帄	LBMN
幅	LBMRW
幨	LBNCR
鄁	LBNL
帷	LBOG
帢	LBOMR
幠	LBOTF
幘	LBQMC
裯	LBQR
幧	LBRRD
幝	LBRRJ
幄	LBSMG
帳	LBSMV
??	LBSTT
盅	LBT
幙	LBTAK
幪	LBTBO
幞	LBTCO
帡	LBTT
幭	LBTWI
冘	LBU
??	LBUMT
幗	LBWIM
??	LBY
幀	LBYBC
??	LBYCK
幟	LBYIA
帖	LBYR
幢	LBYTG
幛	LBYTJ
鄪	LCNL
裕	LCOR
裞	LCRU
衯	LCSH
襋	LDBB
襟	LDDF
襻	LDDQ
被	LDHE
??	LDJ
袂	LDK
褘	LDMQ
隶	LE
褬	LEED
裰	LEEE
衩	LEI
襒	LFBK
襠	LFBW
裧	LFF
袢	LFQ
裷	LFQU
書	LGA
晝	LGAM
袡	LGB
裬	LGCE
??	LGG
襓	LGGU
褂	LGGY
袪	LGI
??	LGP
袺	LGR
襭	LGRC
襩	LGWC
畫	LGWM
袙	LHA
襖	LHBK
袶	LHEQ
袼	LHER
衽	LHG
衫	LHHH
袾	LHJD
??	LHON
褷	LHOO
袛	LHPM
袟	LHQO
褊	LHSB
??	LHUC
襣	LHUL
??	LHUT
衹	LHVP
裨	LHWJ
??	LHWS
褫	LHYU
蚎	LIA
??	LIABT
蝐	LIABU
蝞	LIAHU
蝍	LIAIL
蝪	LIAMH
蝭	LIAMO
蜴	LIAPH
??	LIAPP
蝎	LIAPV
蚆	LIAU
蛝	LIAV
蠍	LIAVO
蟃	LIAWE
螟	LIBAC
螖	LIBBB
蝸	LIBBR
蠳	LIBCV
蛶	LIBDI
蜩	LIBGR
??	LIBHF
蛆	LIBM
蝯	LIBME
蜉	LIBND
褦	LIBP
??	LIBQR
蠼	LIBUE
蠷	LIBUG
蜆	LIBUU
螇	LIBVK
??	LIBY
蚣	LICI
螉	LICIM
蚥	LICK
蛻	LICRU
蚡	LICSH
蚞	LID
蜙	LIDCI
蚾	LIDHE
蜥	LIDHL
蚗	LIDK
蝀	LIDW
蝃	LIEEE
??	LIEG
蟝	LIESD
蛸	LIFB
螳	LIFBG
蟷	LIFBW
蠑	LIFFD
蟧	LIFFS
蜷	LIFQU
蚺	LIGB
蛙	LIGG
蟯	LIGGU
蛣	LIGR
蟢	LIGRR
蟛	LIGTH
蟂	LIHAD
蝗	LIHAG
??	LIHDF
蝌	LIHDJ
蜊	LIHDN
蟋	LIHDP
蜲	LIHDV
蟠	LIHDW
??	LIHEG
蜂	LIHEJ
??	LIHG
??	LIHJ
蛛	LIHJD
蝩	LIHJG
蛞	LIHJR
蟜	LIHKB
蝺	LIHLB
蚚	LIHML
蚸	LIHMY
虮	LIHN
虴	LIHP
蚳	LIHPM
蛾	LIHQI
蛈	LIHQO
蚝	LIHQU
螄	LIHRB
螐	LIHRF
蝙	LIHSB
蜧	LIHSK
蚅	LIHSU
螝	LIHUI
螑	LIHUK
螅	LIHUP
蛌	LIHVO
蚔	LIHVP
蜱	LIHWJ
蟌	LIHWP
蜺	LIHXU
螔	LIHYU
蜋	LIIAV
襂	LIIH
蛑	LIIHQ
蝛	LIIHV
螂	LIIIL
蜅	LIIJB
蛷	LIIJE
蟡	LIIKF
蛂	LIIKK
蚘	LIIKU
螗	LIILR
蠀	LIIOC
蜮	LIIRM
蠊	LIITC
蟅	LIITF
蝷	LIITU
蛖	LIIUH
螰	LIIXP
補	LIJB
蝻	LIJBJ
螲	LIJCG
蚑	LIJE
??	LIJHR
??	LIJIG
蟪	LIJIP
??	LIJIV
褲	LIJJ
螹	LIJJL
蝫	LIJKA
蜨	LIJLO
蠙	LIJMC
蝖	LIJMM
蜿	LIJNU
蛇	LIJP
螛	LIJQR
蛄	LIJR
蝴	LIJRB
蟦	LIJTC
蟟	LIKCF
袚	LIKK
蛦	LIKN
螏	LIKOK
蛺	LIKOO
螮	LIKPB
蟲	LILII
蠱	LILIT
蝂	LILLE
螻	LILLV
蚰	LILW
蜵	LILXL
虹	LIM
蛨	LIMA
蠕	LIMBB
蝢	LIMBC
蝡	LIMBK
蚽	LIMFM
螈	LIMHF
蛭	LIMIG
虷	LIMJ
??	LIMJR
??	LIMMI
蚖	LIMMU
蜄	LIMMV
虰	LIMN
蛚	LIMNN
蚵	LIMNR
蛃	LIMOB
??	LIMOC
蝠	LIMRW
蠣	LIMTB
蚜	LIMVH
蛵	LIMVM
螵	LIMWF
蟫	LIMWJ
蝒	LIMWL
??	LIMY
蟓	LINAO
蝜	LINBC
蟾	LINCR
蜢	LINDT
蝚	LINHD
蜭	LINHX
蛹	LINIB
蜓	LINKG
蜒	LINKM
蚓	LINL
蛫	LINMU
蝑	LINOB
蝮	LIOAE
蚋	LIOB
蚹	LIODI
蜼	LIOG
蟭	LIOGF
蛉	LIOII
蚙	LIOIN
??	LIOIR
??	LIOKG
蜘	LIOKR
??	LIOLD
蚧	LIOLL
蚯	LIOM
蜦	LIOMB
蜍	LIOMD
蝓	LIOMN
蛤	LIOMR
蝓	LIOMV
虼	LION
蜁	LIONO
蟘	LIOPC
蚱	LIOS
蛜	LIOSK
虳	LIPI
??	LIPIM
??	LIPM
蚐	LIPMM
蜪	LIPOU
蚍	LIPP
蝔	LIPPA
蜌	LIPPG
蚼	LIPR
蝶	LIPTD
蚌	LIQJ
??	LIQJO
螓	LIQKD
蜻	LIQMB
??	LIQMF
蝳	LIQMY
蚨	LIQO
蜎	LIRB
??	LIRRI
蟬	LIRRJ
蝦	LIRSE
蟤	LIRUC
蜈	LIRVK
蠅	LIRXU
蝘	LISAV
蠾	LISEI
蠮	LISEM
虭	LISH
蛁	LISHR
??	LISHX
蜛	LISJR
蠗	LISMG
蟉	LISMH
蟳	LISMI
蚇	LISO
螞	LISQF
蟶	LISRG
蚷	LISS
蜡	LITA
蟆	LITAK
褯	LITB
蠓	LITBO
??	LITCL
蝤	LITCW
蟻	LITGI
??	LITGR
蜣	LITGU
蟒	LITIT
蟥	LITLC
蝧	LITLK
螼	LITLM
蠨	LITLX
蚶	LITM
蜞	LITMC
??	LITOB
蠖	LITOE
蠂	LITPD
蛘	LITQ
蠸	LITRG
蛢	LITT
??	LITTR
??	LITVP
蛐	LITW
螬	LITWA
蠛	LITWI
虯	LIU
蝬	LIUCE
??	LIUHJ
螘	LIUMT
蜬	LIUNE
蠵	LIUOB
??	LIVFI
蟣	LIVII
??	LIVIM
蚴	LIVIS
虯	LIVL
蝝	LIVNO
蠟	LIVVV
蝟	LIWB
蜾	LIWD
蟔	LIWGF
蜠	LIWHD
蟈	LIWIM
蠋	LIWLI
蠌	LIWLJ
蠉	LIWLV
蝹	LIWOT
蛔	LIWR
螺	LIWVF
蠝	LIWWW
??	LIY
螁	LIYAV
蠬	LIYBP
螃	LIYBS
螪	LIYCB
蛟	LIYCK
蛀	LIYG
??	LIYGQ
蚢	LIYHN
蟙	LIYIA
蟀	LIYIJ
蚪	LIYJ
蚊	LIYK
??	LIYLB
??	LIYOJ
蠦	LIYPT
蛅	LIYR
蠩	LIYRA
蜳	LIYRD
蝏	LIYRN
蠔	LIYRO
蠰	LIYRV
蝣	LIYSD
蟑	LIYTJ
螭	LIYUB
虻	LIYV
蚿	LIYVI
蟺	LIYWM
蠐	LIYX
袕	LJC
褣	LJCR
衼	LJE
襶	LJIC
褚	LJKA
袉	LJP
史	LK
盎	LKBT
鴦	LKHAF
袸	LKLD
裺	LKLU
襫	LKMA
褲	LKMS
裌	LKOO
??	LKSQF
串	LL
暢	LLAMH
??	LLBK
衴	LLBU
??	LLBUU
朄	LLDWF
牉	LLFQ
牘	LLGWC
版	LLHE
??	LLHJX
牖	LLHSB
牌	LLHWJ
??	LLHWP
牋	LLII
川	LLL
順	LLLC
??	LLLLL
褸	LLLV
??	LLMJX
片	LLML
裶	LLMY
弗	LLN
牏	LLOMN
??	LLOMV
患	LLP
褙	LLPB
??	LLPC
牒	LLPTD
牊	LLSHR
婁	LLV
袖	LLW
丳	LLWW
裫	LLXL
牓	LLYBS
袹	LMA
襦	LMBB
貴	LMBUC
衧	LMD
賮	LMFBC
盡	LMFBT
虫	LMI
裲	LMLB
劃	LMLN
襹	LMMP
裖	LMMV
北	LMP
邶	LMPNL
裋	LMRT
褔	LMRW
非	LMSY
剕	LMSYN
??	LMTB
兆	LMUO
頫	LMUOC
??	LMUOF
覜	LMUOU
褥	LMVI
褾	LMWF
褼	LMWU
鬥	LN
襐	LNAO
費	LNBUC
襜	LNCR
衱	LNHE
鬩	LNHXU
襁	LNII
刜	LNLN
鬫	LNMJK
??	LNMML
鬥	LNMTI
艴	LNNAU
鬮	LNNXU
襏	LNOE
鬥	LNRML
鬨	LNTC
??	LNTCU
鬧	LNYLB
複	LOAE
衲	LOB
??	LOGD
??	LOGTE
衽	LOHG
袗	LOHH
袱	LOIK
襳	LOIM
衿	LOIN
襘	LOMA
褕	LOMN
襝	LOMO
袷	LOMR
褕	LOMV
袘	LOPD
褓	LORD
??	LOTO
忠	LP
背	LPB
衪	LPD
??	LPH
??	LPHH
??	LPHN
??	LPIM
袀	LPMM
??	LPPA
??	LPPP
袧	LPR
袍	LPRU
褋	LPTD
冀	LPWTC
聿	LQ
褉	LQHK
衋	LQMAT
??	LQMC
裱	LQMV
衭	LQO
裐	LRB
裎	LRHG
裎	LRMG
襙	LRRD
襌	LRRJ
??	LRUC
??	LRVK
冂	LS
褗	LSAV
初	LSH
袑	LSHR
襤	LSIT
裾	LSJR
裙	LSKR
褶	LSMA
襑	LSMI
韭	LSMM
襤	LSMT
??	LSMV
襺	LTBI
襆	LTCO
襼	LTGI
??	LTLB
褡	LTOR
襪	LTWI
襛	LTWV
儿	LU
沊	LUE
鴆	LUHAF
邥	LUNL
胤	LVBU
鷜	LVHAF
氀	LVHQU
??	LVII
袎	LVIS
褖	LVNO
數	LVOK
袽	LVR
由	LW
冑	LWB
裸	LWD
裡	LWG
??	LWHDW
裀	LWK
申	LWL
襡	LWLI
襗	LWLJ
??	LWLM
襬	LWLP
甹	LWMVS
褞	LWOT
曳	LWP
??	LWTC
肅	LX
鷫	LXHAF
??	LXNO
??	LYAU
褪	LYAV
褅	LYBB
??	LYBG
襱	LYBP
棐	LYD
襯	LYDU
??	LYGQ
??	LYHQU
??	LYHS
??	LYIK
裗	LYIU
褳	LYJJ
輩	LYJWJ
奜	LYK
??	LYLM
蜚	LYLMI
??	LYMR
餥	LYOIV
悲	LYP
??	LYPN
??	LYPU
??	LYRAU
翡	LYSMM
??	LYTG
襚	LYTO
褵	LYUB
婓	LYV
袨	LYVI
襢	LYWM
裴	LYYHV
斐	LYYK
??	LYYMR
一	M
百	MA
厭	MABK
櫫	MAD
厬	MAHR
戩	MAI
亙	MAM
皕	MAMA
碧	MAMR
厚	MAND
鄑	MANL
??	MBA
??	MBAAH
??	MBABT
霾	MBBHG
霢	MBBHV
??	MBBUU
??	MBC
廁	MBCN
??	MBCP
雰	MBCSH
??	MBD
霜	MBDBU
霖	MBDD
霦	MBDDH
耐	MBDI
??	MBDJE
霪	MBEBG
霘	MBEBR
霂	MBED
??	MBEGI
??	MBEHV
霈	MBEJB
??	MBELU
靋	MBEMM
霐	MBENI
??	MBEPU
霟	MBETC
霮	MBETV
霑	MBEYR
??	MBEYS
霄	MBFB
??	MBFD
??	MBFHU
??	MBG
鷊	MBHAF
??	MBHDF
??	MBHER
雽	MBHFD
耏	MBHHH
霤	MBHHW
霺	MBHOK
??	MBHP
??	MBHQU
??	MBHSK
霓	MBHXU
戛	MBI
??	MBIJB
??	MBIXP
??	MBJB
霋	MBJLV
耎	MBK
勵	MBKS
雵	MBLBK
而	MBLL
融	MBLMI
雿	MBLMO
霏	MBLMY
電	MBLWU
亙	MBM
需	MBMBL
璽	MBMGI
靂	MBMHM
雲	MBMMI
雩	MBMMS
震	MBMMV
??	MBMR
??	MBNAU
??	MBND
??	MBNHB
??	MBNHE
??	MBNHK
霧	MBNHS
霿	MBNHU
雺	MBNIH
霆	MBNKG
邴	MBNL
??	MBNLM
??	MBNNN
??	MBNOO
霯	MBNOT
鬺	MBOAH
??	MBOD
霍	MBOG
??	MBOGF
靃	MBOGG
零	MBOII
??	MBOLF
霉	MBOWY
恧	MBP
憂	MBPHE
雹	MBPRU
??	MBQJM
霣	MBRBC
霵	MBRJI
露	MBRMR
靈	MBRRO
霝	MBRRR
霞	MBRSE
??	MBRYO
霨	MBSFI
雪	MBSM
霫	MBSMA
翮	MBSMM
霹	MBSRJ
霰	MBTBK
??	MBTBO
??	MBTGK
霸	MBTJB
霙	MBTLK
雸	MBTM
??	MBTMC
??	MBTWT
頁	MBUC
鬷	MBUCE
耍	MBV
??	MBVFG
雷	MBW
??	MBWBT
霬	MBWTC
電	MBWU
??	MBWWW
靇	MBYBP
??	MBYBS
霩	MBYDL
雱	MBYHS
??	MBYHV
雯	MBYK
霅	MBYMR
??	MBYMY
靄	MBYRV
??	MBYT
霠	MBYTN
霎	MBYTV
??	MBYVG
霽	MBYX
??	MC
??	MCA
夒	MCHE
西	MCW
酉	MCWM
于	MD
盂	MDBT
??	MDDA
??	MDDR
鷅	MDHAF
五	MDM
邘	MDNL
汞	ME
??	MEBU
亟	MEM
鄾	MENL
??	MER
不	MF
爾	MFBK
甭	MFBQ
盃	MFBT
??	MFBUU
鴀	MFHAF
彯	MFHHH
飄	MFHNI
瓢	MFHVO
平	MFJ
??	MFJBM
奀	MFK
??	MFKS
剽	MFLN
丕	MFM
願	MFMBC
??	MFMFF
??	MFMWV
歪	MFMYM
鄢	MFNL
愿	MFP
否	MFR
??	MFRAU
翲	MFSMM
孬	MFVND
王	MG
??	MGA
琩	MGAA
??	MGABT
瑁	MGABU
瑆	MGAHM
瑂	MGAHU
瑒	MGAMH
??	MGAMO
??	MGANW
??	MGAPH
琨	MGAPP
琶	MGAU
??	MGAWE
璟	MGAYF
琝	MGAYK
再	MGB
璦	MGBBE
珊	MGBBM
琛	MGBCD
瓔	MGBCV
??	MGBD
琱	MGBGR
琿	MGBJJ
珇	MGBM
瑗	MGBME
琈	MGBND
瑤	MGBOU
??	MGBQR
琤	MGBSD
珊	MGBT
??	MGBTV
珼	MGBUC
現	MGBUU
玬	MGBY
??	MGC
??	MGCI
珶	MGCNH
玢	MGCSH
璔	MGCWA
??	MGD
??	MGDBU
??	MGDCI
琳	MGDD
玻	MGDHE
玦	MGDK
??	MGDKR
??	MGDLC
瑋	MGDMQ
??	MGDOO
??	MGDW
??	MGDWF
琺	MGEGI
瑵	MGEII
??	MGEMN
??	MGESD
??	MGFB
??	MGFBB
瑣	MGFBC
??	MGFBG
璫	MGFBW
璘	MGFDQ
琰	MGFF
??	MGFFD
??	MGFFI
??	MGFMG
珖	MGFMU
??	MGFOG
??	MGG
珃	MGGB
??	MGGCE
珪	MGGG
??	MGGI
瓙	MGGNF
??	MGGNI
??	MGGRR
璈	MGGSK
??	MGGTJ
珀	MGHA
瑔	MGHAE
??	MGHAF
??	MGHAG
??	MGHBR
珘	MGHBY
??	MGHDC
琍	MGHDN
琇	MGHDS
璠	MGHDW
致	MGHE
??	MGHEJ
珞	MGHER
??	MGHEY
珗	MGHGU
??	MGHHE
珋	MGHHL
琉	MGHHW
珠	MGHJD
??	MGHJE
??	MGHJU
??	MGHKB
瑀	MGHLB
??	MGHML
珮	MGHNB
??	MGHNI
珩	MGHON
瑽	MGHOO
??	MGHPA
珴	MGHQI
??	MGHQM
??	MGHRB
瓚	MGHUC
瑰	MGHUI
??	MGHWJ
璁	MGHWP
璵	MGHXC
??	MGHXH
??	MGHXU
玉	MGI
琅	MGIAV
??	MGICE
瑊	MGIHR
??	MGIHS
琖	MGII
瑯	MGIIL
球	MGIJE
班	MGILG
瑭	MGILR
珆	MGIR
璷	MGISK
瑱	MGJBC
??	MGJBJ
瑏	MGJCH
瑢	MGJCR
??	MGJHR
瑼	MGJII
??	MGJIP
??	MGJKI
??	MGJKP
璸	MGJMC
琮	MGJMF
瑄	MGJMM
??	MGJMO
??	MGJMU
琬	MGJNU
瑚	MGJRB
琯	MGJRR
??	MGJV
??	MGJWJ
珛	MGKB
??	MGKGG
琋	MGKKB
珔	MGKLD
琦	MGKMR
珈	MGKSR
??	MGLBK
玔	MGLLL
??	MGLMC
珧	MGLMO
璶	MGLMT
琲	MGLMY
到	MGLN
??	MGLPC
珒	MGLQ
珅	MGLWL
玒	MGM
??	MGMA
瓀	MGMBB
頊	MGMBC
??	MGMBE
??	MGMBW
??	MGMCA
玗	MGMD
??	MGMFB
玶	MGMFJ
??	MGMFM
玨	MGMG
璱	MGMGH
??	MGMGI
??	MGMGN
??	MGMHF
琊	MGMHL
??	MGMHM
臸	MGMIG
玕	MGMJ
??	MGMMP
珸	MGMMR
玩	MGMMU
玎	MGMN
珂	MGMNR
??	MGMPM
琢	MGMSO
玡	MGMVH
甄	MGMVN
??	MGMWB
瑮	MGMWD
??	MGMWF
??	MGMWG
瓊	MGNBE
瑍	MGNBK
??	MGNBS
??	MGNCR
??	MGNF
璚	MGNHB
珽	MGNKG
??	MGNKQ
郅	MGNL
??	MGNLB
玖	MGNO
璒	MGNOT
珍	MGOHH
玲	MGOII
琴	MGOIN
玳	MGOIP
瑲	MGOIR
玝	MGOJ
??	MGOJU
致	MGOK
玠	MGOLL
璯	MGOMA
??	MGOMB
??	MGOMG
瑜	MGOMN
珨	MGOMR
瑜	MGOMV
琁	MGONO
??	MGOQ
??	MGOS
??	MGOWY
??	MGP
珣	MGPA
??	MGPD
瑟	MGPH
玓	MGPI
??	MGPIM
??	MGPM
??	MGPMM
琵	MGPP
瑎	MGPPA
玸	MGPRU
玴	MGPT
玤	MGQJ
??	MGQKA
瑧	MGQKD
??	MGQKI
琫	MGQKQ
??	MGQMC
??	MGQMF
??	MGQMY
??	MGQO
琄	MGRB
??	MGRBC
珵	MGRHG
??	MGRMG
璐	MGRMR
??	MGRPA
噩	MGRR
璪	MGRRD
??	MGRRJ
??	MGRRK
瑕	MGRSE
??	MGRU
??	MGRVP
珿	MGRYO
??	MGSEG
玿	MGSHR
??	MGSIT
珥	MGSJ
琚	MGSJR
??	MGSK
珺	MGSKR
璆	MGSMH
璕	MGSMI
璻	MGSMJ
珝	MGSMM
??	MGSMT
瑪	MGSQF
弄	MGT
??	MGTAW
琠	MGTBC
瑐	MGTBN
珙	MGTC
??	MGTCA
??	MGTCD
??	MGTCG
璞	MGTCO
??	MGTGK
瓂	MGTGT
??	MGTGU
??	MGTHS
??	MGTJP
??	MGTKR
璊	MGTLB
璜	MGTLC
瑛	MGTLK
瑾	MGTLM
??	MGTLO
玵	MGTM
??	MGTMA
琪	MGTMC
??	MGTMJ
瑹	MGTOD
瓁	MGTOE
??	MGTOP
珜	MGTQ
??	MGTQD
瑳	MGTQM
瓘	MGTRG
璥	MGTRK
??	MGTUI
??	MGTWT
??	MGU
??	MGUAP
??	MGUHJ
??	MGUJF
瑞	MGUMB
??	MGUMT
瓗	MGUOB
璀	MGUOG
琌	MGUON
瓅	MGVID
璣	MGVII
琭	MGVNE
瑑	MGVNO
璅	MGVVD
瑙	MGVVW
理	MGWG
??	MGWIM
??	MGWJC
珚	MGWK
玾	MGWL
??	MGWLJ
環	MGWLV
??	MGWOT
瓃	MGWWW
??	MGYBB
??	MGYBC
璭	MGYBJ
瓛	MGYBK
瓏	MGYBP
璿	MGYBU
??	MGYCB
珓	MGYCK
璨	MGYED
琡	MGYFE
琉	MGYIU
璉	MGYJJ
玟	MGYK
??	MGYKB
斑	MGYKG
??	MGYKH
玼	MGYMP
??	MGYMR
璡	MGYOG
??	MGYPN
璩	MGYPO
琥	MGYPU
玷	MGYR
??	MGYRD
??	MGYRF
??	MGYRN
瓖	MGYRV
??	MGYSD
璇	MGYSO
璋	MGYTJ
璲	MGYTO
琣	MGYTR
璃	MGYUB
玹	MGYVI
瑰	MGYWV
璾	MGYX
??	MGYY
瓋	MGYYB
厂	MH
原	MHAF
曆	MHDA
厤	MHDD
歷	MHDM
??	MHDP
磿	MHDR
鴉	MHHAF
厜	MHJM
邪	MHNL
雅	MHOG
餮	MHOIV
厎	MHPM
靉	MIBBE
??	MIF
至	MIG
魂	MIHUI
晉	MIIA
鄏	MINL
霒	MIOIN
??	MIPU
厖	MIUH
靆	MIYLE
干	MJ
??	MJB
厧	MJBC
??	MJBM
??	MJD
烎	MJF
鳱	MJHAF
??	MJHX
麉	MJIXP
刊	MJLN
頇	MJMBC
幵	MJMJ
??	MJMJG
邢	MJMJL
刑	MJMJN
邗	MJNL
敢	MJOK
舌	MJR
厙	MJWJ
天	MK
??	MKA
??	MKAB
??	MKC
??	MKD
??	MKE
壓	MKG
??	MKHAF
甦	MKHQM
魘	MKHUI
??	MKLMI
靨	MKMWL
郠	MKNL
饜	MKOIV
忝	MKP
吞	MKR
功	MKS
无	MKU
嬮	MKV
黶	MKWGF
厴	MKWL
丌	ML
??	MLB
兩	MLBO
雨	MLBY
亞	MLLM
工	MLM
州	MLML
厞	MLMY
丏	MLVS
更	MLWK
二	MM
??	MMAU
麗	MMBBP
??	MMBBV
項	MMBC
??	MMEE
示	MMF
堊	MMG
鵡	MMHAF
云	MMI
厔	MMIG
勁	MMKS
亓	MML
蝁	MMLMI
剄	MMLN
三	MMM
頸	MMMBC
??	MMMGI
辰	MMMV
亍	MMN
邳	MMNL
次	MMNO
政	MMOK
惡	MMP
吾	MMR
??	MMRHU
廚	MMTI
元	MMU
廈	MMUE
??	MMUG
黿	MMUU
厊	MMVH
瓨	MMVN
巧	MMVS
??	MMW
巰	MMYIU
虣	MMYPU
丁	MN
殂	MNBM
殍	MNBND
銎	MNC
烈	MNF
型	MNG
殪	MNGBT
殰	MNGWC
殦	MNHAF
殈	MNHBT
瓩	MNHJ
殊	MNHJD
殀	MNHK
歿	MNHNE
殙	MNHPA
殠	MNHUK
歹	MNI
殘	MNII
殏	MNIJE
殆	MNIR
殖	MNJBM
殯	MNJMC
殑	MNJRU
殗	MNKLU
殎	MNKOO
殢	MNKPB
邛	MNL
殃	MNLBK
殔	MNLE
蛩	MNLMI
列	MNLN
肂	MNLQ
頂	MNMBC
殛	MNMEM
殌	MNMVM
殭	MNMWM
歿	MNNE
??	MNNL
鮤	MNNWF
殤	MNOAH
殄	MNOHH
殲	MNOIM
??	MNOIV
殮	MNOMO
死	MNP
殉	MNPA
歾	MNPHH
可	MNR
殞	MNRBC
殫	MNRRJ
跫	MNRYO
??	MNSHE
??	MNSJ
鞏	MNTLJ
殣	MNTLM
姴	MNV
殟	MNWOT
殧	MNYFU
裂	MNYHV
殕	MNYTR
仄	MO
??	MOABT
豝	MOAU
豤	MOAV
丙	MOB
資	MOBUC
覡	MOBUU
豯	MOBVK
栥	MOD
燹	MOF
贗	MOFC
粢	MOFD
??	MOG
??	MOGA
豷	MOGBT
鷢	MOHAF
??	MOHD
鴈	MOHF
豵	MOHOO
??	MOHQM
豟	MOHSN
豬	MOJKA
豶	MOJTC
厒	MOJU
攻	MOK
豨	MOKKB
蟨	MOLMI
劂	MOLN
豲	MOMHF
豜	MOMJJ
??	MOMO
豩	MOMSO
豜	MOMT
瓷	MOMVN
巫	MOO
雁	MOOG
餈	MOOIV
恣	MOP
咨	MOR
??	MORD
豭	MORSE
??	MORYO
厏	MOS
姿	MOV
豱	MOWOT
豥	MOYVO
鸝	MPHAF
??	MPHHH
酈	MPNL
武	MPYLM
??	MQOHH
石	MR
??	MRAA
碭	MRAMH
礙	MRAMI
碣	MRAPV
硍	MRAV
硼	MRBB
碢	MRBBR
碉	MRBGR
鞷	MRBJ
??	MRBKF
鬲	MRBL
砠	MRBM
硐	MRBMR
??	MRBOU
??	MRBQ
??	MRBQR
碀	MRBSD
碙	MRBTU
硯	MRBUU
磎	MRBVK
砃	MRBY
??	MRC
砏	MRCSH
??	MRCST
磳	MRCWA
碴	MRDAM
硹	MRDCI
碄	MRDD
礎	MRDDO
破	MRDHE
??	MRDI
??	MRDJ
砵	MRDM
砅	MRE
磉	MREED
磲	MRESD
硝	MRFB
礑	MRFBW
磷	MRFDQ
??	MRFF
??	MRFFD
礯	MRFFF
砂	MRFH
??	MRG
硅	MRGG
磽	MRGGU
砝	MRGI
磕	MRGIT
硈	MRGR
礂	MRGRR
磝	MRGSK
??	MRHA
??	MRHBT
磻	MRHDW
硌	MRHER
??	MRHG
硞	MRHGR
砭	MRHIO
硃	MRHJD
碫	MRHJE
??	MRHJG
硾	MRHJM
??	MRHJU
礄	MRHKB
礩	MRHLC
斫	MRHML
砓	MRHNE
??	MRHNI
矺	MRHP
??	MRHPA
砥	MRHPM
??	MRHQ
硪	MRHQI
??	MRHQR
碥	MRHSB
礉	MRHSK
砨	MRHSN
礸	MRHUC
磈	MRHUI
碑	MRHWJ
磃	MRHYU
??	MRI
硠	MRIAV
??	MRICI
??	MRICR
??	MRIDI
??	MRIDR
砯	MRIE
磩	MRIHF
鹼	MRIHR
??	MRIHS
磣	MRIIH
磄	MRILR
礦	MRITC
硥	MRIUH
磌	MRJBC
硿	MRJCM
??	MRJCN
磚	MRJII
??	MRJKP
礗	MRJMC
碇	MRJMO
碗	MRJNU
確	MRJOG
砣	MRJP
磍	MRJQR
??	MRJRB
??	MRJV
硨	MRJWJ
磢	MRKKK
碕	MRKMR
??	MRKNI
硤	MRKOO
??	MRLL
??	MRLLL
砩	MRLLN
刮	MRLN
硉	MRLQ
砷	MRLWL
矼	MRM
礝	MRMBB
碩	MRMBC
礭	MRMBG
礵	MRMBU
礌	MRMBW
硒	MRMCW
砰	MRMFJ
砡	MRMGI
??	MRMGN
??	MRMHL
矸	MRMJ
研	MRMJJ
??	MRMJN
??	MRMLB
硬	MRMLK
??	MRMMI
??	MRMMU
??	MRMN
砢	MRMNR
碔	MRMPM
砳	MRMR
磊	MRMRR
研	MRMT
礪	MRMTB
硎	MRMTN
矹	MRMU
磭	MRMVB
砑	MRMVH
硜	MRMVM
??	MRMVN
磹	MRMWJ
礓	MRMWM
??	MRMWV
确	MRNBG
矷	MRND
砐	MRNHE
矽	MRNI
郚	MRNL
硊	MRNMU
砍	MRNO
磴	MRNOT
磔	MRNQD
哥	MRNR
確	MROBG
碓	MROG
磼	MROGD
礁	MROGF
砱	MROII
??	MROIN
??	MROK
砎	MROLL
碖	MROMB
硢	MROMD
??	MROMG
??	MROMN
??	MROMR
??	MROMV
矻	MRON
??	MROPD
砟	MROS
礙	MRPKO
砒	MRPP
砲	MRPRU
砌	MRPSH
碟	MRPTD
??	MRPU
??	MRQHK
碃	MRQMB
磧	MRQMC
碡	MRQMY
砆	MRQO
隕	MRRBC
磾	MRRRJ
礹	MRRRK
碬	MRRSE
??	MRSC
礥	MRSEC
砲	MRSFK
礛	MRSIT
??	MRSJB
砸	MRSLB
磟	MRSMH
??	MRSMM
??	MRSMT
??	MRSNO
碼	MRSQF
礔	MRSRJ
??	MRSRO
??	MRSRR
碾	MRSTV
豆	MRT
碏	MRTA
碘	MRTBC
礤	MRTBF
礞	MRTBO
??	MRTC
??	MRTEI
礒	MRTGI
??	MRTGK
??	MRTGO
??	MRTGR
礡	MRTII
磺	MRTLC
碤	MRTLK
??	MRTMH
碪	MRTMV
??	MRTOR
??	MRTOV
??	MRTPD
磋	MRTQM
??	MRTR
??	MRTRG
??	MRTST
??	MRTT
碰	MRTTC
碰	MRTTM
??	MRTTR
??	MRTUI
磁	MRTVI
磡	MRTVS
??	MRTWA
??	MRTWI
磏	MRTXC
硭	MRTYV
磞	MRUBB
??	MRUMB
碳	MRUMF
??	MRUMR
磑	MRUMT
??	MRUOB
磪	MRUOG
礫	MRVID
磯	MRVII
碌	MRVNE
??	MRVVW
??	MRWC
硱	MRWD
碅	MRWHD
??	MRWJC
碨	MRWMV
磥	MRWVF
礧	MRWWW
砪	MRWYI
碲	MRYBB
磅	MRYBS
礅	MRYDK
砫	MRYG
??	MRYHR
硫	MRYIU
??	MRYK
碎	MRYOJ
??	MRYPT
砧	MRYR
碻	MRYRB
碠	MRYRN
砬	MRYT
??	MRYTJ
碚	MRYTR
??	MRYTU
??	MRYUP
??	MRYVO
??	MRYWD
磠	MRYWI
万	MS
豕	MSHO
豖	MSKO
??	MSL
鄠	MSNL
攷	MSOK
厄	MSU
开	MT
厝	MTA
廝	MTCL
鳽	MTHAF
形	MTHHH
豍	MTHWJ
豉	MTJE
豌	MTJNU
??	MTLM
刑	MTLN
豇	MTM
頭	MTMBC
邢	MTNL
??	MTNOK
雃	MTOG
揅	MTQ
豏	MTTXC
厥	MTUO
厲	MTWB
兀	MU
朁	MUA
蠶	MUALI
襾	MUB
炁	MUF
??	MUHAF
夏	MUHE
??	MUHG
戛	MUI
奡	MUKLL
??	MULMC
虺	MULMI
刓	MULN
頑	MUMBC
鬵	MUMRB
豗	MUMSO
邧	MUNL
卼	MUNMU
畫	MUW
匚	MV
脣	MVB
牙	MVDH
辱	MVDI
旡	MVKU
蜃	MVLMI
瓦	MVNI
互	MVNM
覅	MVPHH
唇	MVR
??	MVS
巠	MVVM
醞	MWABT
醒	MWAHM
覃	MWAJ
醍	MWAMO
酹	MWBDI
酮	MWBMR
賈	MWBUC
靦	MWBUU
釂	MWBWI
酚	MWCSH
栗	MWD
醂	MWDD
??	MWDHE
酎	MWDI
醊	MWEEE
??	MWF
粟	MWFD
??	MWFF
厘	MWG
??	MWGG
??	MWGNI
鶝	MWHAF
酥	MWHD
酪	MWHER
醺	MWHGF
酷	MWHGR
覂	MWHIO
酘	MWHNE
覆	MWHOE
??	MWHQR
酕	MWHQU
覈	MWHSK
醜	MWHUI
醙	MWHXE
??	MWICD
酸	MWICE
??	MWICY
醾	MWIDD
??	MWIDY
??	MWIHR
醆	MWII
酺	MWIJB
酬	MWILL
醣	MWILR
??	MWIR
??	MWITF
醡	MWJCS
??	MWJDI
醏	MWJKA
酵	MWJKD
酡	MWJP
酤	MWJR
醐	MWJRB
醃	MWKLU
??	MWKMB
醢	MWKRT
??	MWKS
酖	MWLBU
蠠	MWLII
醠	MWLKT
??	MWLLL
??	MWLMC
??	MWLMY
副	MWLN
醓	MWLUT
??	MWLX
醹	MWMBB
醽	MWMBR
??	MWMD
??	MWMDP
酐	MWMJ
??	MWMKU
酬	MWMLL
票	MWMMF
釃	MWMMP
酊	MWMN
酠	MWMNR
醥	MWMWF
醰	MWMWJ
酩	MWNIR
醑	MWNOB
醱	MWNOE
醀	MWOG
醮	MWOGF
??	MWOMA
酴	MWOMD
酢	MWOS
酯	MWPA
酏	MWPD
酌	MWPI
酌	MWPM
醄	MWPOU
??	MWQMF
??	MWQO
酲	MWRHG
酲	MWRMG
釅	MWRRK
面	MWSL
醪	MWSMH
??	MWSMR
醧	MWSRR
配	MWSU
醋	MWTA
醭	MWTCO
??	MWTGS
霸	MWTJB
羈	MWTJF
??	MWTJR
醼	MWTLF
酣	MWTM
??	MWTOD
醛	MWTOG
醝	MWTQM
??	MWTWA
醴	MWTWT
醲	MWTWV
酗	MWUK
要	MWV
酳	MWVIB
醁	MWVNE
??	MWW
醳	MWWLJ
醞	MWWOT
??	MWYBP
醚	MWYFD
醯	MWYIT
??	MWYIU
??	MWYJ
醉	MWYOJ
醵	MWYPO
酟	MWYR
??	MWYRB
醇	MWYRD
釀	MWYRV
醷	MWYTP
醅	MWYTR
醨	MWYUB
歃	MXNO
下	MY
龐	MYBP
焉	MYLF
正	MYLM
忑	MYP
厗	MYTJ
丐	MYVS
弓	N
兔	NAHI
免	NAHU
象	NAPO
色	NAU
觛	NBAM
弸	NBB
敻	NBBUE
??	NBC
觖	NBDK
觫	NBDL
觥	NBFMU
角	NBG
觟	NBGG
鷸	NBHAF
??	NBHDS
觡	NBHER
觝	NBHPM
氄	NBHQU
觚	NBHVO
觬	NBHXU
觩	NBIJE
觰	NBJKA
奐	NBK
觭	NBKMR
勇	NBKS
触	NBLMI
劀	NBLN
觨	NBME
瓕	NBMGI
觼	NBNBE
觙	NBNHE
觤	NBNMU
觴	NBOAH
隳	NBOP
恿	NBP
??	NBPPK
觶	NBRRJ
解	NBSHQ
觲	NBTGQ
觾	NBTLF
解	NBTQ
嶞	NBU
負	NBUC
彏	NBUE
觿	NBUOB
觻	NBVID
觓	NBVL
??	NBVNE
觸	NBWLI
斛	NBYJ
小	NC
詹	NCYMR
子	ND
??	NDBBR
孟	NDBT
??	NDFOG
鶔	NDHAF
孫	NDHVF
孤	NDHVO
孮	NDJMF
孻	NDLMT
孺	NDMBB
孲	NDMLM
孖	NDND
孜	NDOK
孢	NDPRU
孔	NDU
孩	NDYVO
潭	NE
??	NEAU
??	NED
丞	NEM
脀	NEMB
烝	NEMF
巹	NEMSU
爾	NF
鯧	NFAA
??	NFABT
鰣	NFAGI
鯽	NFAIL
鯷	NFAMO
鯤	NFAPP
鰨	NFASM
鰻	NFAWE
弰	NFB
??	NFBCJ
??	NFBCN
鯛	NFBGR
鮦	NFBMR
鰶	NFBOF
鰩	NFBOU
??	NFBQR
鮵	NFCRU
魵	NFCSH
??	NFDBN
粥	NFDN
鯠	NFDOO
??	NFDWF
??	NFDYN
鮹	NFFB
鱨	NFFBA
鱗	NFFDQ
魦	NFFH
鯪	NFGCE
鯥	NFGCG
鮭	NFGG
鱙	NFGGU
魼	NFGI
鮚	NFGR
鰉	NFHAG
穌	NFHD
??	NFHDA
鯚	NFHDD
鰍	NFHDF
鱕	NFHDW
魬	NFHE
鮥	NFHER
??	NFHEY
??	NFHFP
??	NFHGR
鰡	NFHHW
鱵	NFHIR
鮢	NFHJD
鱎	NFHKB
鯦	NFHOR
魠	NFHP
??	NFHQR
鰤	NFHRB
魴	NFHSB
鯀	NFHVF
鱮	NFHXC
鯓	NFHXH
鯢	NFHXU
??	NFHYR
鰔	NFIHR
鯆	NFIJB
鯄	NFIJE
魷	NFIKU
??	NFILO
鮐	NFIR
??	NFITC
鰫	NFJCR
鮇	NFJD
鱄	NFJII
??	NFJIM
鯇	NFJMU
鮀	NFJP
鰭	NFJPA
鮕	NFJR
鰗	NFJRB
鮪	NFKB
??	NFKCE
??	NFKDE
??	NFKSR
??	NFLL
??	NFLLL
鮡	NFLMO
鯡	NFLMY
??	NFLN
鱐	NFLX
魟	NFM
??	NFMBB
鮞	NFMBL
鱈	NFMBM
??	NFMCW
魾	NFMFM
鱷	NFMGR
鯁	NFMLK
鱺	NFMMP
鯃	NFMMR
魺	NFMNR
??	NFMOO
鱱	NFMTB
鱖	NFMTO
魱	NFMVM
鰾	NFMWF
??	NFMWJ
鱌	NFNAO
鮸	NFNAU
鱊	NFNHB
鰇	NFNHD
鰎	NFNKQ
??	NFNMM
鮠	NFNMU
鱍	NFNOE
??	NFNQD
鰒	NFOAE
魶	NFOB
鮒	NFODI
鯰	NFOIP
鰷	NFOLD
鱠	NFOMA
鮽	NFOMD
鮯	NFOMR
鯸	NFONK
魤	NFOP
鮓	NFOS
愻	NFP
鮨	NFPA
鮅	NFPH
魡	NFPI
??	NFPIM
??	NFPM
??	NFPMM
鮈	NFPR
鮑	NFPRU
鰈	NFPTD
魨	NFPU
鰆	NFQKA
鯖	NFQMB
鰿	NFQMC
鱢	NFRRD
??	NFRRJ
??	NFRRS
??	NFRSE
鱦	NFRXU
鰋	NFSAV
鰹	NFSEG
魛	NFSH
鯫	NFSJE
鮿	NFSJU
鮶	NFSKR
鰼	NFSMA
鯞	NFSMB
鱘	NFSMI
??	NFSMM
??	NFSS
??	NFTCW
鱔	NFTGR
??	NFTIS
鰳	NFTJS
魽	NFTM
鯕	NFTMC
??	NFTOE
鮮	NFTQ
鱹	NFTRG
??	NFTRS
鱔	NFTTR
鰽	NFTWA
鱒	NFTWI
鱧	NFTWT
鰜	NFTXC
鱳	NFVID
鯔	NFVVW
鯉	NFWG
魻	NFWL
鰅	NFWLB
鰥	NFWLE
鰥	NFWLO
鱞	NFWLV
鮂	NFWO
??	NFWOT
鰓	NFWP
鮫	NFYCK
魧	NFYHN
魴	NFYHS
??	NFYIU
鰱	NFYJJ
魰	NFYK
??	NFYLE
鮛	NFYMF
鱁	NFYMO
鰬	NFYPK
鱋	NFYPM
??	NFYPN
鱸	NFYPT
??	NFYPU
??	NFYR
鰝	NFYRB
鯙	NFYRD
鯨	NFYRF
鱆	NFYTJ
鯜	NFYTV
鱣	NFYWM
鱭	NFYX
丑	NG
??	NGI
頲	NGMBC
疆	NGMWM
矞	NHBCR
柔	NHD
及	NHE
??	NHFB
務	NHHES
虱	NHLI
蟊	NHLII
??	NHOII
矜	NHOIN
務	NHOKS
弤	NHPM
乃	NHS
騭	NHSQF
矠	NHTA
弧	NHVO
夕	NI
甬	NIBQ
鵵	NIHAF
夤	NIJMC
強	NILI
劖	NILN
矛	NINH
多	NINI
酁	NINL
予	NINN
飧	NIOIV
舛	NIQ
名	NIR
夗	NISU
??	NITC
??	NIV
??	NIWJ
外	NIY
謽	NIYMR
癶	NIYO
??	NJG
鳵	NJHAF
蝨	NJLII
??	NJP
又	NK
??	NKA
瞀	NKBU
鍪	NKC
楘	NKD
煞	NKF
堥	NKG
迫	NKHA
鶩	NKHAF
廷	NKHG
延	NKHYM
戣	NKI
蝥	NKLMI
建	NKLQ
??	NKMCW
鄈	NKNL
??	NKRHG
??	NKRXU
??	NKRYO
騖	NKSQF
鞪	NKTLJ
婺	NKV
迴	NKWR
引	NL
??	NLA
陽	NLAMH
隄	NLAMO
??	NLAT
限	NLAV
隰	NLAVF
阻	NLBM
隱	NLBMP
際	NLBOF
盄	NLBT
陂	NLDHE
??	NLDLK
陳	NLDW
敶	NLDWK
??	NLEMN
??	NLFBW
鄰	NLFDQ
隙	NLFHF
陵	NLGCE
陸	NLGCG
隢	NLGGU
阹	NLGI
隞	NLGSK
陡	NLGYO
隍	NLHAG
隩	NLHBK
阪	NLHE
隆	NLHEM
降	NLHEQ
??	NLHHW
阡	NLHJ
陎	NLHJD
隀	NLHJG
陲	NLHJM
阺	NLHPM
??	NLHRF
??	NLHTA
陞	NLHTG
隗	NLHUI
陴	NLHWJ
隉	NLHXG
??	NLHXM
阭	NLIHU
隇	NLIHV
??	NLJE
??	NLJHP
陼	NLJKA
院	NLJMU
陀	NLJP
??	NLJTC
??	NLJV
陣	NLJWJ
陏	NLKB
??	NLKCF
??	NLKIG
隋	NLKMB
隓	NLKMM
陭	NLKMR
陓	NLKMS
陜	NLKOO
阞	NLKS
隤	NLLMC
陫	NLLMY
陌	NLMA
??	NLMBB
陾	NLMBK
陑	NLMBL
陋	NLMBV
隬	NLMFB
??	NLMJJ
阮	NLMMU
阿	NLMNR
陃	NLMOB
隔	NLMRB
阨	NLMSU
??	NLMT
阢	NLMU
陘	NLMVM
??	NLMWG
陷	NLNHX
陊	NLNIN
阠	NLNJ
??	NLNQG
附	NLODI
陰	NLOII
隆	NLOKM
??	NLOM
陯	NLOMB
除	NLOMD
隃	NLOMN
險	NLOMO
隃	NLOMV
阣	NLON
阼	NLOS
??	NLOSI
阤	NLPD
陱	NLPFD
陶	NLPOU
阰	NLPP
階	NLPPA
陛	NLPPG
??	NLQMF
隕	NLRBC
陷	NLSHX
??	NLSJ
陬	NLSJE
??	NLTA
??	NLTCG
隘	NLTCT
??	NLTLM
隊	NLTPO
??	NLTRD
阱	NLTT
隒	NLTXC
??	NLUJF
隑	NLUMT
隅	NLWLB
隈	NLWMV
隴	NLYBP
??	NLYCK
隡	NLYHM
阬	NLYHN
防	NLYHS
隨	NLYKB
隡	NLYKM
陟	NLYLH
阯	NLYLM
阽	NLYR
??	NLYSG
??	NLYTI
障	NLYTJ
隧	NLYTO
陪	NLYTR
陔	NLYVO
隮	NLYX
弼	NMAN
??	NMD
疏	NMDL
彌	NMFB
蜑	NMLMI
彐	NMM
弱	NMNIM
郔	NMNL
鶸	NMNMF
??	NMOK
急	NMP
危	NMSU
弳	NMVM
彊	NMWM
疏	NMYIU
了	NN
廴	NNK
??	NNKF
孑	NNM
預	NNMBC
鬻	NNMRB
豫	NNNAO
孓	NNO
夠	NNPR
承	NNQO
??	NNSL
翗	NNSMM
郺	NNVVU
欠	NO
胥	NOB
鐆	NOC
弣	NODI
灸	NOF
墜	NOG
癹	NOHNE
飛	NOHTO
蛋	NOLMI
癸	NOMK
登	NOMRT
發	NONHE
??	NONOO
??	NORAU
??	NOV
弛	NPD
丮	NQ
桀	NQD
蟹	NQLMI
強	NRLI
??	NRMBC
甔	NRMVN
??	NROG
毚	NRPPI
彈	NRRJ
??	NRSL
盈	NSBT
鼐	NSBUL
爭	NSD
尕	NSF
夃	NSHE
弨	NSHR
弭	NSJ
??	NSLN
張	NSMV
孕	NSND
急	NSP
彄	NSRR
??	NSS
凳	NTHN
戤	NTI
??	NTKS
彉	NTLC
鄧	NTNL
乙	NU
??	NUBT
眢	NUBU
弢	NUE
鴛	NUHAF
勉	NUKS
??	NULB
頠	NUMBC
??	NUNL
??	NUNWF
??	NUOG
怨	NUP
駌	NUSQF
??	NUTWT
妴	NUV
魚	NWF
魯	NWFA
??	NWFNF
螴	NWLMI
彋	NWLV
??	NWPF
彃	NWTJ
卍	NX
燄	NXFF
欿	NXNO
龜	NXU
疋	NYO
弶	NYRF
弦	NYVI
人	O
??	OA
倡	OAA
复	OAHE
劊	OALN
但	OAM
偍	OAMO
們	OAN
??	OANA
僩	OANB
鄶	OANL
倱	OAPP
偈	OAPV
傝	OASM
儤	OATE
佷	OAV
儑	OAVF
僈	OAWE
內	OB
俷	OBAU
倗	OBB
??	OBBB
僾	OBBE
儩	OBCH
側	OBCN
隺	OBG
偁	OBGB
倜	OBGR
鸙	OBHAF
龢	OBHD
偽	OBHF
??	OBHG
??	OBHN
伔	OBHU
??	OBMBC
俱	OBMC
侗	OBMR
俘	OBND
??	OBNO
肉	OBO
傺	OBOF
傜	OBOU
憊	OBP
龤	OBPPA
佣	OBQ
倜	OBQR
??	OBSD
俔	OBUU
俀	OBV
傒	OBVK
??	OBY
仈	OC
佾	OCB
伀	OCI
??	OCNH
俗	OCOR
侻	OCRU
份	OCSH
僧	OCWA
休	OD
??	ODBUC
鎥	ODC
倯	ODCI
僸	ODDF
儊	ODDO
敘	ODE
煲	ODF
堡	ODG
鵂	ODHF
付	ODI
??	ODLC
??	ODLK
体	ODM
偉	ODMQ
雓	ODOG
敘	ODOK
??	ODOO
怹	ODP
??	ODSMA
糴	ODSMG
敘	ODYE
斜	ODYJ
??	OE
伙	OF
俏	OFB
償	OFBC
儻	OFBF
倘	OFBR
儅	OFBW
??	OFD
僯	OFDQ
倓	OFF
僗	OFFS
鷦	OFHAF
偗	OFHU
劁	OFLN
??	OFMBC
??	OFMU
甒	OFMVN
鄦	OFNL
您	OFP
伴	OFQ
倦	OFQU
仕	OG
??	OGB
賃	OGBUC
倰	OGCE
集	OGD
侍	OGDI
雙	OGE
焦	OGF
佳	OGG
僥	OGGU
鶴	OGHAF
??	OGHN
??	OGHQ
佉	OGI
隼	OGJ
雋	OGLMS
剉	OGLN
??	OGMBC
??	OGNHS
儔	OGNI
雔	OGOG
雥	OGOGG
??	OGP
售	OGR
儓	OGRG
僖	OGRR
傲	OGSK
倖	OGTJ
儥	OGWC
讎	OGYMR
讎	OGYRG
入	OH
伯	OHA
偟	OHAG
侐	OHBT
侜	OHBY
傻	OHCE
偢	OHDF
俬	OHDI
俐	OHDN
僁	OHDP
??	OHDR
??	OHDS
倭	OHDV
僠	OHDW
??	OHE
??	OHEQ
佫	OHER
佟	OHEY
??	OHFD
僽	OHFP
??	OHFS
任	OHG
??	OHGS
侁	OHGU
仟	OHJ
侏	OHJD
偅	OHJG
倕	OHJM
佸	OHJR
偛	OHJX
僑	OHKB
偊	OHLB
??	OHLO
伒	OHML
仉	OHN
佩	OHNB
??	OHNF
??	OHNH
偑	OHNI
偺	OHOA
偫	OHOI
傱	OHOO
??	OHP
低	OHPM
件	OHQ
俄	OHQI
佚	OHQO
??	OHQQ
偏	OHSB
僱	OHSG
儌	OHSK
儹	OHUC
傀	OHUI
係	OHVF
仰	OHVL
俾	OHWJ
傯	OHWP
??	OHXE
倪	OHXU
??	OHYA
傂	OHYU
伐	OI
??	OIABT
??	OIAM
餳	OIAMH
餛	OIAPP
餲	OIAPV
倉	OIAR
食	OIAV
饅	OIAWE
傅	OIBI
餫	OIBJJ
餇	OIBMR
??	OIBT
餒	OIBV
俊	OICE
餩	OICYO
餗	OIDL
餟	OIEEE
饓	OIFBD
??	OIFBG
餤	OIFF
饐	OIGBT
饒	OIGGU
饁	OIGIT
饎	OIGRR
鴒	OIHAF
餭	OIHAG
餉	OIHBR
餧	OIHDV
飯	OIHE
??	OIHER
傶	OIHF
飪	OIHG
飹	OIHHL
餾	OIHHW
餂	OIHJR
飫	OIHK
飢	OIHN
餰	OIHON
飥	OIHP
侔	OIHQ
餓	OIHQI
??	OIHQM
饡	OIHUC
餽	OIHUI
??	OIHVO
餿	OIHXE
俴	OII
餺	OIIBI
餕	OIICE
餞	OIII
??	OIIIT
餔	OIIJB
??	OIILR
飴	OIIR
??	OIJB
餑	OIJBD
俅	OIJE
餬	OIJRB
館	OIJRR
饙	OIJTC
伏	OIK
偽	OIKF
餚	OIKKB
优	OIKU
傭	OILB
饋	OILMC
蝕	OILMI
??	OILMO
??	OILMT
韱	OILSM
領	OIMBC
餪	OIMBK
??	OIMJ
餂	OIMJR
飣	OIMN
佽	OIMO
餖	OIMRT
瓴	OIMVN
??	OIMWV
今	OIN
貪	OINC
餡	OINHX
令	OINI
飲	OINO
念	OINP
含	OINR
饞	OINRI
盦	OINT
衾	OINV
酓	OINW
??	OINWF
俯	OIOI
俟	OIOK
飭	OIOKS
飾	OIOLB
餘	OIOMD
??	OIOMG
餼	OIOND
餱	OIONK
代	OIP
儦	OIPF
飶	OIPH
飽	OIPRU
飩	OIPU
??	OIQ
佁	OIR
饌	OIRUC
??	OISHX
餌	OISJ
翎	OISMM
飼	OISMR
饇	OISRR
??	OIT
饃	OITAK
饛	OITBO
??	OITCT
??	OITGF
??	OITGR
??	OITGT
餀	OITK
??	OITLF
饉	OITLM
??	OITOR
饈	OITQG
餅	OITT
??	OITTR
姇	OIV
饑	OIVII
餯	OIVNO
餵	OIWMV
??	OIWOT
餃	OIYCK
??	OIYG
饖	OIYMH
饟	OIYRV
??	OIYTR
饘	OIYWM
什	OJ
伂	OJB
傎	OJBC
值	OJBM
倥	OJCM
傛	OJCR
伎	OJE
侘	OJHP
傳	OJII
??	OJIJ
??	OJIP
??	OJJK
??	OJJO
仗	OJK
??	OJKA
??	OJKD
佬	OJKP
使	OJLK
倳	OJLN
倢	OJLO
儐	OJMC
倧	OJMF
啎	OJMMR
佇	OJMN
傢	OJMO
倇	OJNU
??	OJOG
佗	OJP
儜	OJPN
估	OJR
做	OJRK
倌	OJRR
僨	OJTC
僿	OJTG
缶	OJU
侒	OJV
??	OJWJ
矢	OK
侑	OKB
??	OKC
僚	OKCF
矰	OKCWA
??	OKD
??	OKE
焂	OKF
瀪	OKHAE
??	OKHAF
??	OKHDS
矮	OKHDV
俇	OKHG
矨	OKHK
矯	OKHKB
??	OKI
俙	OKKB
傸	OKKK
佈	OKLB
??	OKLD
俺	OKLU
佐	OKM
倷	OKMF
倚	OKMR
短	OKMRT
侉	OKMS
仇	OKN
矧	OKNL
??	OKNWF
雉	OKOG
??	OKOK
俠	OKOO
矬	OKOOG
悠	OKP
??	OKQO
知	OKR
跾	OKRYO
仂	OKS
伽	OKSR
矩	OKSS
矱	OKTOE
??	OKV
繁	OKVIF
矲	OKWLP
仲	OL
佒	OLBK
??	OLK
介	OLL
佛	OLLN
僂	OLLV
僓	OLMC
佻	OLMO
儘	OLMT
俳	OLMY
候	OLNK
脩	OLOB
條	OLOD
儵	OLOF
修	OLOH
鞗	OLOJ
攸	OLOK
翛	OLOM
??	OLP
偝	OLPB
伸	OLWL
俜	OLWS
丘	OM
佰	OMA
儒	OMBB
??	OMBD
優	OMBE
侕	OMBL
俞	OMBN
愈	OMBP
侖	OMBT
??	OMBV
兵	OMC
余	OMD
伍	OMDM
悆	OMDP
峹	OMDU
畬	OMDW
伓	OMF
??	OMFB
伻	OMFJ
伾	OMFM
??	OMFN
俖	OMFR
全	OMG
??	OMGB
倒	OMGN
乒	OMH
儮	OMHM
乓	OMI
侄	OMIG
??	OMJN
舍	OMJR
??	OMJS
??	OMJX
倆	OMLB
便	OMLK
仁	OMM
佘	OMMF
伝	OMMI
仨	OMMM
佽	OMMO
儷	OMMP
俉	OMMR
??	OMMU
佞	OMMV
仃	OMN
邱	OMNL
例	OMNN
歙	OMNO
何	OMNR
倵	OMPM
合	OMR
龠	OMRB
命	OMRL
僉	OMRO
??	OMRQ
偪	OMRW
卸	OMSL
屔	OMSP
侀	OMTN
岳	OMU
僭	OMUA
??	OMUC
伢	OMVH
俓	OMVM
佤	OMVN
會	OMWA
價	OMWC
僳	OMWD
僄	OMWF
偭	OMWL
僵	OMWM
僊	OMWU
偠	OMWV
傿	OMYF
??	OMYM
乞	ON
??	ONA
氳	ONABT
??	ONAMH
像	ONAO
??	ONAPH
俛	ONAU
??	ONB
偩	ONBC
??	ONBK
??	ONBS
覦	ONBUU
儋	ONCR
氛	ONCSH
仔	OND
??	ONDW
你	ONF
??	ONFB
氣	ONFD
氮	ONFF
??	ONG
鳹	ONHAF
僪	ONHB
伋	ONHE
氡	ONHEY
毹	ONHQU
仍	ONHS
俑	ONIB
侈	ONIN
??	ONIR
氪	ONJRU
氨	ONJV
侹	ONKG
鄇	ONKL
健	ONKQ
氕	ONL
氘	ONLL
氚	ONLLL
氟	ONLLN
刉	ONLN
氠	ONLWL
氥	ONMCW
??	ONMG
侯	ONMK
氬	ONMLM
??	ONMNR
??	ONMOB
佹	ONMU
氫	ONMVM
氖	ONNHS
鄃	ONNL
歈	ONNO
??	ONNST
氝	ONOB
雂	ONOG
忥	ONP
傑	ONQD
氰	ONQMB
儳	ONRI
??	ONRRJ
氧	ONTQ
氙	ONU
氯	ONVNE
??	ONW
??	ONWD
??	ONWJR
氤	ONWK
氳	ONWOT
氦	ONYVO
??	ONYWI
從	OO
傷	OOAH
傕	OOBG
俎	OOBM
肏	OOBO
??	OOBU
??	OOF
坐	OOG
夎	OOGE
僬	OOGF
??	OOGS
僋	OOIC
伶	OOII
仱	OOIN
傖	OOIR
仵	OOJ
价	OOLL
劍	OOLN
儈	OOMA
倫	OOMB
顩	OOMBC
佺	OOMG
偷	OOMN
儉	OOMO
佮	OOMR
??	OOMV
仡	OON
歛	OONO
眾	OOO
侳	OOOG
傘	OOOJ
斂	OOOK
??	OOQ
作	OOS
??	OOSHI
佡	OOU
侮	OOWY
化	OP
侚	OPA
貨	OPBUC
他	OPD
??	OPFD
??	OPG
佖	OPH
牮	OPHQ
儗	OPKO
傯	OPKP
傾	OPMC
敜	OPOK
仳	OPP
偕	OPPA
佝	OPR
伳	OPT
偞	OPTD
岱	OPU
黛	OPWGF
袋	OPYHV
年	OQ
偰	OQHK
??	OQJ
偆	OQKA
??	OQKD
傣	OQKE
俸	OQKQ
倩	OQMB
債	OQMC
傃	OQMF
俵	OQMV
伕	OQO
僣	OQOA
??	OQOC
智	ORA
俋	ORAU
??	ORB
盒	ORBT
??	ORBU
伿	ORC
保	ORD
??	ORDF
樖	ORDMR
鴿	ORHAF
侶	ORHR
侃	ORHU
戧	ORI
舖	ORIJB
館	ORJRR
創	ORLN
頜	ORMBC
??	ORMVN
??	ORMWT
舒	ORNIN
郃	ORNL
欱	ORNO
??	OROP
拿	ORQ
??	ORQQ
僤	ORRJ
儼	ORRK
??	ORRR
??	ORRS
假	ORSE
偮	ORSJ
翕	ORSMM
弇	ORT
??	ORTM
??	ORTOP
僎	ORUC
俁	ORVK
畣	ORW
僶	ORXU
龕	ORYBP
敆	ORYE
??	ORYHV
促	ORYO
乍	OS
偃	OSAV
矱	OSD
??	OSHC
仞	OSHI
??	OSHR
佴	OSJ
倨	OSJR
伊	OSK
??	OSKR
??	OSM
侵	OSME
偓	OSMG
僇	OSMH
伺	OSMR
倀	OSMV
僝	OSND
伬	OSO
怎	OSP
傌	OSQF
僻	OSRJ
??	OSRL
傴	OSRR
佢	OSS
侷	OSSR
偋	OSTT
倔	OSUU
借	OTA
??	OTAP
倎	OTBC
供	OTC
??	OTCA
??	OTCH
僕	OTCO
??	OTCT
偤	OTCW
橆	OTDD
無	OTF
儀	OTGI
??	OTGV
備	OTHB
??	OTHG
儰	OTIF
偌	OTKR
??	OTLC
偀	OTLK
僅	OTLM
??	OTLO
??	OTM
??	OTMA
倛	OTMC
??	OTMH
偡	OTMV
舞	OTNIQ
儺	OTOG
??	OTPD
佯	OTQ
傞	OTQM
儆	OTRK
傇	OTSJ
併	OTT
傋	OTTB
傮	OTWA
僔	OTWI
儚	OTWN
??	OTWT
儂	OTWV
傔	OTXC
仙	OU
罈	OUAMI
傰	OUBB
??	OUBTU
傻	OUCE
缺	OUDK
缽	OUDM
缹	OUF
??	OUHAF
缿	OUHMR
??	OULLL
??	OULMO
缸	OUM
偳	OUMB
??	OUMF
罈	OUMWJ
??	OUOB
催	OUOG
侺	OUON
罐	OUTRG
缾	OUTT
??	OUTWI
??	OUWJC
缾	OUYJJ
??	OUYMR
罅	OUYPD
罏	OUYPT
覦	OVBUU
??	OVHQU
似	OVIO
??	OVNG
??	OVNL
??	OVNO
侞	OVR
儠	OVVV
佃	OW
??	OWC
??	OWD
俚	OWG
個	OWJR
偶	OWLB
儸	OWLG
儇	OWLV
偎	OWMV
偲	OWP
佪	OWR
儽	OWWF
??	OWWM
儡	OWWW
每	OWYI
韽	OWYTA
仆	OY
倬	OYAJ
??	OYBB
偵	OYBC
儱	OYBP
傍	OYBS
佼	OYCK
儭	OYDU
俶	OYFE
僦	OYFU
住	OYG
??	OYHH
伉	OYHN
仿	OYHS
依	OYHV
??	OYJJ
??	OYK
??	OYKH
傚	OYKK
??	OYLB
企	OYLM
仩	OYM
??	OYMD
佌	OYMP
信	OYMR
佧	OYMY
倅	OYOJ
敏	OYOK
偨	OYPD
儢	OYPP
佔	OYR
儲	OYRA
??	OYRD
倞	OYRF
停	OYRN
??	OYRO
儴	OYRV
倣	OYSK
??	OYSO
位	OYT
偣	OYTA
僮	OYTG
傽	OYTJ
億	OYTP
倍	OYTR
??	OYTV
禽	OYUB
伭	OYVI
侅	OYVO
??	OYVW
儃	OYWM
儕	OYX
毓	OYYIU
心	P
旬	PA
慍	PABT
??	PAC
??	PAFU
鶛	PAHAF
惺	PAHM
慨	PAIU
勓	PAKS
怛	PAM
愓	PAMH
悍	PAMJ
惿	PAMO
憪	PANB
憫	PANK
郇	PANL
??	PANR
惕	PAPH
惃	PAPP
愒	PAPV
懪	PATE
恨	PAV
慢	PAWE
憬	PAYF
慏	PBAC
愲	PBBB
??	PBBE
惻	PBCN
墯	PBG
惆	PBGR
慆	PBHX
惲	PBJJ
怚	PBM
愋	PBME
恫	PBMR
??	PBOF
愮	PBOU
??	PBQR
惘	PBTV
??	PBUC
戄	PBUE
懼	PBUG
慀	PBVK
惍	PC
忪	PCI
勩	PCKS
悌	PCNH
悅	PCRU
憎	PCWA
也	PD
惏	PDD
鵴	PDHAF
忖	PDI
快	PDK
悚	PDL
懶	PDLC
穎	PDMBC
??	PDMQ
惙	PEEE
怪	PEG
慅	PEII
潁	PEMBC
悄	PFB
戃	PFBF
??	PFBG
惝	PFBR
匊	PFD
憐	PFDQ
惔	PFF
??	PFFS
穎	PFMBC
恍	PFMU
怑	PFQ
惓	PFQU
恃	PGDI
憢	PGGU
怯	PGI
懤	PGNI
恄	PGR
??	PGRR
憉	PGTH
悻	PGTJ
必	PH
怕	PHA
惶	PHAG
懊	PHBK
甮	PHBQ
恦	PHBR
恤	PHBT
覕	PHBUU
懰	PHCN
憡	PHDB
悸	PHDD
愀	PHDF
??	PHDN
恪	PHER
悎	PHGR
慟	PHGS
勿	PHH
??	PHHAF
匑	PHHN
忏	PHJ
恬	PHJR
憍	PHKB
悿	PHKP
懫	PHLC
刎	PHLN
忻	PHML
??	PHNI
邲	PHNL
忽	PHP
惛	PHPA
性	PHQM
怢	PHQO
??	PHQR
惼	PHSB
憿	PHSK
??	PHST
愧	PHUI
??	PHVIF
忯	PHVP
??	PHWP
袃	PHYHV
勾	PI
悢	PIAV
??	PIBI
悛	PICE
??	PICY
怵	PID
??	PIDY
慘	PIIH
匍	PIJB
怵	PIJC
慵	PILB
慷	PILE
勻	PIM
怡	PIR
憾	PIRP
悈	PIT
懭	PITC
怴	PIV
惦	PIYR
慎	PJBC
悖	PJBD
??	PJBM
懥	PJBO
悾	PJCM
??	PJD
忮	PJE
鴇	PJHAF
愘	PJHR
慱	PJII
憓	PJIP
慚	PJJL
??	PJKD
恅	PJKP
悽	PJLV
悰	PJMF
愃	PJMM
惋	PJNU
懧	PJPN
怙	PJR
悺	PJRR
駂	PJSQF
憤	PJTC
忕	PK
憭	PKCF
恢	PKF
??	PKHN
??	PKI
匆	PKK
悕	PKKB
慡	PKKK
怖	PKLB
??	PKLD
肄	PKLQ
匎	PKLU
惰	PKMB
??	PKMBC
恞	PKN
疑	PKNIO
匆	PKP
??	PKS
愶	PKSB
協	PKSS
忡	PL
怏	PLBK
忱	PLBU
怫	PLLN
慺	PLLV
憒	PLMC
恌	PLMO
??	PLMT
悱	PLMY
懻	PLPC
怞	PLW
懨	PMAK
恒	PMAM
懦	PMBB
頃	PMBC
懮	PMBE
恆	PMBM
??	PMBP
恓	PMCW
怀	PMF
怦	PMFJ
怌	PMFM
恬	PMJR
??	PMKP
勻	PMM
??	PMMI
悟	PMMR
忨	PMMU
怲	PMOB
匐	PMRW
憯	PMUA
慄	PMWD
慓	PMWF
憛	PMWJ
愐	PMWL
怔	PMYM
乜	PN
??	PNAI
悗	PNAU
懈	PNBQ
??	PNBS
憺	PNCR
??	PNDU
忸	PNG
憰	PNHB
忣	PNHE
??	PNI
悀	PNIB
恀	PNIN
??	PNKF
??	PNLB
忺	PNO
惤	PNYI
愎	POAE
??	POAH
恘	POD
惟	POG
愯	POGE
憔	POGF
怜	POII
懺	POIM
忴	POIN
??	POIP
愴	POIR
忤	POJ
匋	POJU
惀	POMB
悇	POMD
恮	POMG
愉	POMN
憸	POMO
恰	POMR
??	POMV
忔	PON
觺	PONBG
愾	POND
??	POP
??	POPD
怍	POS
憮	POTF
悔	POWY
比	PP
恂	PPA
惸	PPAD
粊	PPFD
坒	PPG
怭	PPH
皆	PPHA
??	PPHNI
惚	PPHP
毞	PPHQU
??	PPKP
惢	PPP
橤	PPPD
繠	PPPF
毖	PPPH
怐	PPR
怉	PPRU
??	PPT
惵	PPTD
忳	PPU
恟	PPUK
情	PQMB
愫	PQMF
句	PR
悒	PRAU
悁	PRB
鴝	PRHAF
悜	PRHG
斪	PRHML
怳	PRHU
劬	PRKS
??	PRMG
夠	PRNIN
欨	PRNO
雊	PROG
??	PROK
??	PRPA
懆	PRRD
憚	PRRJ
愕	PRRS
包	PRU
??	PRVK
怋	PRVP
憴	PRXU
愝	PSAV
慳	PSEG
切	PSH
??	PSHI
怊	PSHR
??	PSIT
懾	PSJJ
愜	PSKO
慴	PSMA
恇	PSMG
憀	PSMH
憳	PSMI
??	PSMT
悵	PSMV
??	PSND
怩	PSP
慪	PSRR
世	PT
惜	PTA
??	PTAJ
慔	PTAK
懞	PTBO
貰	PTBUC
??	PTCU
懂	PTHG
慲	PTLB
愅	PTLJ
??	PTLK
慬	PTLM
??	PTMS
愖	PTMV
匒	PTOR
懩	PTOV
??	PTPD
??	PTPP
懽	PTRG
??	PTRK
恲	PTT
??	PTVP
慒	PTWA
懱	PTWI
懵	PTWU
慊	PTXC
慌	PTYU
??	PTYV
屯	PU
惾	PUCE
皺	PUDHE
炰	PUF
鶵	PUHAF
匈	PUK
刨	PULN
惴	PUMB
頓	PUMBC
愷	PUMT
鄒	PUNL
雛	PUOG
芻	PUPU
怓	PVE
怮	PVIS
??	PVO
??	PVP
惱	PVVW
甸	PW
怬	PWC
惈	PWD
悝	PWG
慖	PWIM
慣	PWJC
??	PWK
??	PWKP
懌	PWLJ
愣	PWLS
懁	PWLV
愄	PWMV
??	PWNL
慍	PWOT
恛	PWR
??	PWRW
悼	PYAJ
恔	PYCK
??	PYDK
憱	PYFU
??	PYHN
慥	PYHR
??	PYJJ
??	PYLM
訇	PYMR
悴	PYOJ
??	PYPM
懅	PYPO
怗	PYR
惇	PYRD
惊	PYRF
懹	PYRV
??	PYSV
愔	PYTA
憧	PYTG
慞	PYTJ
憶	PYTP
忙	PYV
??	PYVI
慉	PYVW
懍	PYWD
??	PYWF
懷	PYWV
懠	PYX
忭	PYY
手	Q
抇	QA
搵	QABT
??	QAHU
??	QAHUI
??	QAI
揤	QAIL
摡	QAIU
蠢	QALII
擔	QAM
??	QAMG
揚	QAMH
捍	QAMJ
提	QAMO
捫	QAN
??	QANA
撊	QANB
撋	QANG
擱	QANR
攔	QANW
惷	QAP
掍	QAPP
揭	QAPV
撮	QASE
搨	QASM
把	QAU
拫	QAV
捑	QAVK
??	QAYF
抈	QB
掤	QBB
搰	QBBB
授	QBBE
靜	QBBSD
靚	QBBUU
探	QBCD
攖	QBCV
採	QBD
捋	QBDI
鶄	QBHAF
撝	QBHF
??	QBHWU
搯	QBHX
揮	QBJJ
靛	QBJMO
撚	QBKF
抯	QBM
援	QBME
挏	QBMR
靘	QBNAU
捊	QBND
郬	QBNL
??	QBOND
搖	QBOU
掙	QBSD
??	QBTU
攫	QBUE
挸	QBUU
挼	QBV
扒	QC
??	QCHL
掰	QCHQ
勣	QCKS
撳	QCNO
挩	QCRU
扮	QCSH
耒	QD
??	QDAM
耙	QDAU
拺	QDB
??	QDBM
耡	QDBMS
??	QDDQ
??	QDEC
耖	QDFH
披	QDHE
耗	QDHQU
耛	QDIR
抹	QDJ
抉	QDK
耞	QDKSR
??	QDL
耬	QDLLV
頛	QDMBC
耰	QDMBE
耘	QDMMI
耨	QDMVI
耔	QDND
??	QDRAU
耜	QDRLR
??	QDSLL
耟	QDSS
耤	QDTA
??	QDTOE
耕	QDTT
耩	QDTTB
揀	QDWF
耦	QDWLB
耪	QDYBS
搡	QEED
掇	QEEE
??	QEFH
扠	QEI
??	QEID
搔	QEII
捎	QFB
攩	QFBF
撐	QFBH
撇	QFBK
撐	QFBQ
擋	QFBW
掞	QFF
撈	QFFS
抄	QFH
??	QFMU
拌	QFQ
捲	QFQU
??	QFT
??	QFYAJ
抩	QGB
持	QGDI
挂	QGG
撓	QGGU
掛	QGGY
抾	QGI
搕	QGIT
捇	QGLC
擣	QGNI
??	QGOV
拮	QGR
擷	QGRC
抬	QGRG
拍	QHA
揘	QHAG
擳	QHAL
搗	QHAU
攥	QHBF
擙	QHBK
攪	QHBU
??	QHCQ
栔	QHD
揪	QHDF
捼	QHDV
播	QHDW
扳	QHE
捀	QHEJ
挌	QHER
??	QHFS
??	QHG
捁	QHGR
挀	QHHV
抸	QHIO
扦	QHJ
揰	QHJG
捶	QHJM
??	QHJP
括	QHJR
揗	QHJU
插	QHJX
契	QHK
撟	QHKB
掭	QHKP
蛪	QHLMI
掀	QHLO
折	QHML
拆	QHMY
觢	QHNBG
投	QHNE
??	QHNI
揝	QHOA
摐	QHOO
撘	QHOR
托	QHP
抵	QHPM
挈	QHQ
??	QHQL
抶	QHQO
??	QHQR
摀	QHRF
掮	QHSB
撽	QHSK
搧	QHSM
攢	QHUC
擤	QHUL
擨	QHUO
擤	QHUT
撬	QHUU
絜	QHVIF
抑	QHVL
扺	QHVP
捭	QHWJ
摠	QHWP
搜	QHXE
捏	QHXG
捏	QHXM
掜	QHXU
??	QHYA
搬	QHYE
齧	QHYMU
搋	QHYU
找	QI
搏	QIBI
捘	QICE
攠	QICY
攠	QIDY
摵	QIHF
??	QIHM
抁	QIHU
摻	QIIH
捕	QIJB
捄	QIJE
??	QIK
拔	QIKE
撝	QIKF
??	QIKH
拔	QIKK
扰	QIKU
??	QILB
??	QILO
搪	QILR
??	QIOI
挨	QIOK
攗	QIPD
拭	QIPM
??	QIPW
抬	QIR
掝	QIRM
撼	QIRP
拚	QIT
擴	QITC
摭	QITF
??	QIXE
摝	QIXP
掂	QIYR
丰	QJ
搷	QJBC
挬	QJBD
擦	QJBF
揇	QJBJ
??	QJBK
攮	QJBV
控	QJCM
挖	QJCN
??	QJCO
??	QJCR
搾	QJCS
攛	QJCV
技	QJE
挓	QJHP
抭	QJHU
??	QJIG
摶	QJII
撠	QJJI
搟	QJJJ
摲	QJJL
扙	QJK
??	QJKD
拷	QJKS
捷	QJLO
擯	QJMC
??	QJMF
??	QJMI
揎	QJMM
掟	QJMO
砉	QJMR
捖	QJMU
??	QJMW
邦	QJNL
捥	QJNU
摍	QJOA
??	QJOG
??	QJP
搘	QJPA
擰	QJPN
攇	QJQP
搳	QJQR
??	QJRAU
??	QJRC
??	QJRU
彗	QJSM
??	QJSMF
慧	QJSMP
??	QJTI
攓	QJTO
攐	QJTV
按	QJV
捙	QJWJ
春	QKA
摋	QKCE
撩	QKCF
??	QKDE
泰	QKE
拻	QKF
秦	QKHD
奏	QKHK
舂	QKHX
??	QKJ
撦	QKJA
??	QKJT
??	QKKK
抪	QKLB
拵	QKLD
掩	QKLU
捺	QKMF
掎	QKMR
挎	QKMS
??	QKNA
拋	QKNS
挾	QKOO
??	QKPB
奉	QKQ
扐	QKS
搚	QKSB
摦	QKSO
??	QKSR
拹	QKSS
??	QKU
拋	QKUS
晢	QLA
抰	QLBK
抌	QLBU
銴	QLC
??	QLD
捸	QLE
??	QLF
??	QLLB
??	QLLL
蜇	QLLMI
拂	QLLN
摟	QLLV
撌	QLMC
挑	QLMO
硩	QLMR
排	QLMY
悊	QLP
揹	QLPB
哲	QLR
踅	QLRYO
擻	QLVK
抽	QLW
抻	QLWL
拽	QLWP
裚	QLYHV
誓	QLYMR
扛	QM
擫	QMAK
青	QMB
擩	QMBB
摃	QMBC
擾	QMBE
攉	QMBG
摴	QMBS
責	QMBUC
擂	QMBW
??	QMCW
扜	QMD
??	QME
抔	QMF
??	QMFB
抨	QMFJ
捱	QMGG
捯	QMGN
??	QMGT
??	QMHL
搢	QMIA
挃	QMIG
扞	QMJ
撖	QMJK
括	QMJR
插	QMJX
??	QMKP
??	QML
挭	QMLK
掗	QMLM
抎	QMMI
攦	QMMP
捂	QMMR
抏	QMMU
振	QMMV
打	QMN
??	QMOB
拓	QMR
搹	QMRB
揊	QMRW
扼	QMSU
撅	QMTO
扤	QMU
??	QMUE
表	QMV
素	QMVIF
挳	QMVM
搮	QMWD
摽	QMWF
撢	QMWJ
纛	QMWYF
毒	QMWYI
挽	QNAU
捔	QNBG
換	QNBK
擔	QNCR
搎	QNDF
拯	QNEM
扭	QNG
揉	QNHD
扱	QNHE
扔	QNHS
掐	QNHX
捅	QNIB
??	QNII
抒	QNIN
??	QNJ
挺	QNKG
挻	QNKM
揵	QNKQ
撱	QNLB
搦	QNMM
扻	QNO
揟	QNOB
撥	QNOE
揆	QNOK
撜	QNOT
攙	QNRI
??	QNSD
??	QNUS
擼	QNWA
??	QNWP
夫	QO
替	QOA
摥	QOAH
搉	QOBG
??	QOBUC
規	QOBUU
拊	QODI
推	QOG
??	QOGF
鳺	QOHAF
拰	QOHG
抮	QOHH
拎	QOII
攕	QOIM
扲	QOIN
捻	QOIP
搶	QOIR
輦	QOJWJ
扴	QOLL
??	QOM
掄	QOMB
??	QOMC
捈	QOMD
拴	QOMG
揄	QOMN
撿	QOMO
拾	QOMR
??	QOMV
扢	QON
邞	QONL
挫	QOOG
拖	QOPD
搿	QORQ
揜	QORT
??	QOS
撫	QOTF
挴	QOWY
摿	QOYA
擒	QOYB
??	QOYM
指	QPA
扡	QPD
掬	QPFD
扚	QPI
??	QPJC
??	QPK
擬	QPKO
??	QPM
揯	QPMM
掏	QPOU
批	QPP
揩	QPPA
拘	QPR
抱	QPRU
抴	QPT
揲	QPTD
扽	QPU
搊	QPUU
揈	QPYR
??	QQ
揳	QQHK
??	QQJL
??	QQKD
揍	QQKK
捧	QQKQ
??	QQKX
掅	QQMB
扶	QQO
攆	QQOJ
摫	QQOU
掱	QQQ
扥	QQU
扣	QR
挹	QRAU
捐	QRB
損	QRBC
??	QRHU
拐	QRKS
??	QRLB
??	QRP
操	QRRD
撣	QRRJ
??	QRRK
??	QRSE
拐	QRSH
揖	QRSJ
捌	QRSN
撰	QRUC
??	QRVK
抿	QRVP
捉	QRYO
揠	QSAV
??	QSEG
摨	QSEQ
??	QSHI
招	QSHR
??	QSHU
掐	QSHX
挕	QSJ
掫	QSJE
攝	QSJJ
揶	QSJL
据	QSJR
捃	QSKR
挋	QSLL
摺	QSMA
掃	QSMB
握	QSMG
摎	QSMH
撏	QSMI
掁	QSMV
??	QSND
抳	QSP
挪	QSQL
擗	QSRJ
摳	QSRR
拒	QSS
挶	QSSR
摒	QSTT
搌	QSTV
??	QSU
掘	QSUU
攬	QSWU
??	QSYJ
措	QTA
摸	QTAK
擖	QTAV
??	QTAW
捵	QTBC
攃	QTBF
撒	QTBK
揃	QTBN
拱	QTC
??	QTCG
??	QTCH
撕	QTCL
撲	QTCO
搤	QTCT
揂	QTCW
??	QTGO
??	QTGT
擲	QTKL
撗	QTLC
拑	QTM
掑	QTMC
??	QTMD
??	QTMJ
揕	QTMV
搽	QTOD
擭	QTOE
攤	QTOG
??	QTOO
搭	QTOR
攁	QTOV
擛	QTPD
搓	QTQM
??	QTQQ
??	QTQU
擏	QTRK
拼	QTT
搆	QTTB
掽	QTTC
??	QTTM
搠	QTUB
描	QTW
撙	QTWI
擃	QTWV
搛	QTXC
扎	QU
槼	QUD
??	QUHJ
揣	QUMB
??	QUMJ
攜	QUOB
摧	QUOG
拙	QUU
嫢	QUV
紮	QUVIF
??	QVFH
??	QVFN
擽	QVID
拗	QVIS
掾	QVNO
攭	QVOI
摷	QVVD
拶	QVVN
擸	QVVV
捆	QWD
捚	QWG
撂	QWHR
摑	QWIM
摜	QWJC
摁	QWKP
押	QWL
擉	QWLI
擇	QWLJ
擺	QWLP
擐	QWLV
揋	QWMV
搵	QWOT
揌	QWP
摞	QWVF
攌	QWWV
拇	QWYI
憃	QXP
扑	QY
掉	QYAJ
揥	QYBB
攡	QYBG
撤	QYBK
攏	QYBP
搒	QYBS
摘	QYCB
挍	QYCK
??	QYDK
拄	QYG
撻	QYGQ
摓	QYHJ
抗	QYHN
搥	QYHR
挔	QYHV
摔	QYIJ
抖	QYJ
??	QYJI
拼	QYJJ
抆	QYK
捗	QYLH
扯	QYLM
掯	QYMB
攍	QYNV
捽	QYOJ
掖	QYOK
據	QYPO
攄	QYPP
擄	QYPS
攎	QYPT
拈	QYR
搞	QYRB
掠	QYRF
揨	QYRN
攘	QYRV
揓	QYSD
??	QYSV
拉	QYT
撞	QYTG
??	QYTJ
掊	QYTR
摬	QYTU
接	QYTV
摛	QYUB
擁	QYVG
??	QYVQ
搐	QYVW
擅	QYWM
擠	QYX
抃	QYY
擿	QYYB
口	R
唱	RAA
??	RABT
唧	RAIL
??	RAIU
呾	RAM
??	RAMH
哻	RAMJ
??	RANG
??	RANR
嚪	RANX
??	RAPH
喝	RAPV
嘬	RASE
嚗	RATE
吧	RAU
哏	RAV
??	RAWE
敯	RAYE
??	RAYT
肙	RB
噯	RBBE
喎	RBBR
嚶	RBCV
啋	RBD
哷	RBDI
??	RBG
啁	RBGR
鵑	RBHAF
??	RBHF
咀	RBM
哃	RBMR
嗂	RBOU
??	RBQR
??	RBSD
嗣	RBSMR
員	RBUC
??	RBUU
哸	RBV
嚼	RBWI
只	RC
嗡	RCIM
嗲	RCKN
勛	RCKS
鄖	RCNL
吩	RCSH
噌	RCWA
??	RCYRB
呆	RD
喳	RDAM
??	RDBN
噤	RDDF
??	RDHA
氉	RDHQU
吋	RDI
??	RDJR
吷	RDK
喇	RDLN
嗽	RDLO
呠	RDM
喡	RDMQ
鄵	RDNL
唻	RDOO
??	RDRD
啵	REDE
嗓	REED
啜	REEE
唦	REFH
嗨	REOY
吙	RF
哨	RFB
嚐	RFBA
嗩	RFBC
噹	RFBW
咪	RFD
??	RFDQ
啖	RFF
嘮	RFFS
吵	RFH
??	RFQ
??	RFQU
吐	RG
呥	RGB
噎	RGBT
嚇	RGCC
哇	RGG
嘵	RGGU
鷕	RGHAF
呿	RGI
嗑	RGIT
嚽	RGKC
哧	RGLC
郢	RGNL
??	RGOK
??	RGPD
咭	RGR
嘻	RGRR
嗷	RGSK
啈	RGTJ
唗	RGYO
嘄	RHAD
鳴	RHAF
喤	RHAG
嗥	RHAJ
??	RHAM
??	RHB
??	RHBD
噢	RHBK
響	RHBR
??	RHBT
咱	RHBU
??	RHD
啾	RHDF
唎	RHDN
咯	RHER
咚	RHEY
呼	RHFD
呈	RHG
??	RHGF
哠	RHGR
吆	RHI
??	RHJ
咮	RHJD
唾	RHJM
咶	RHJR
喢	RHJX
嘺	RHKB
听	RHML
噬	RHMO
??	RHMY
??	RHNE
喒	RHOA
??	RHOK
吒	RHP
呧	RHPM
吽	RHQ
哦	RHQI
??	RHQR
呂	RHR
嗚	RHRF
噭	RHSK
呏	RHT
兄	RHU
囋	RHUC
??	RHUJ
嗅	RHUK
呱	RHVO
啤	RHWJ
嗖	RHXE
唲	RHXU
??	RHYA
??	RHYU
??	RIAV
唆	RICE
嘛	RIDD
嘁	RIHF
哞	RIHQ
喊	RIHR
吮	RIHU
??	RIHV
啷	RIIL
哺	RIJB
嘛	RIJC
吠	RIK
噅	RIKF
詠	RINE
雖	RIOG
唉	RIOK
咍	RIR
嚝	RITC
喥	RITE
哤	RIUH
??	RJ
嘟	RJAL
嗔	RJBC
哱	RJBD
嗦	RJBF
喃	RJBJ
嚏	RJBO
囔	RJBV
??	RJC
噾	RJCA
味	RJD
吱	RJE
鷤	RJHAF
吒	RJHP
喀	RJHR
戰	RJI
??	RJII
嘲	RJJB
囀	RJJI
??	RJJL
??	RJKA
哮	RJKD
??	RJKF
咾	RJKP
??	RJKS
啑	RJLO
喧	RJMM
辴	RJMMV
啶	RJMO
??	RJMU
鄲	RJNL
嘜	RJON
??	RJP
嗜	RJPA
??	RJPI
嚀	RJPN
嘧	RJPU
嗐	RJQR
咕	RJR
囅	RJSTV
噴	RJTC
??	RJWJ
暋	RKA
睯	RKBU
嘹	RKCF
吰	RKI
??	RKJT
唏	RKKB
咘	RKLB
唵	RKLU
咦	RKN
唊	RKOO
愍	RKP
另	RKS
嗋	RKSB
咖	RKSR
吊	RLB
咈	RLLN
嘍	RLLV
嘳	RLMC
咷	RLMO
??	RLMP
嚍	RLMT
啡	RLMY
呻	RLWL
嘯	RLX
??	RM
??	RMA
咺	RMAM
踼	RMAMH
踶	RMAMO
躝	RMANW
踢	RMAPH
蹋	RMASM
跁	RMAU
跟	RMAV
嚅	RMBB
跚	RMBBM
嗊	RMBC
踩	RMBD
嚘	RMBE
蹈	RMBHX
跙	RMBM
??	RMBME
跚	RMBT
躩	RMBUE
躣	RMBUG
蹊	RMBVK
趴	RMC
哂	RMCW
蹭	RMCWA
吁	RMD
蹅	RMDAM
跛	RMDHE
趹	RMDK
??	RMDL
踏	RMEA
吥	RMF
踃	RMFB
蹚	RMFBG
蹐	RMFCB
蹸	RMFDQ
躞	RMFFE
呯	RMFJ
呸	RMFM
跘	RMFQ
踡	RMFQU
呈	RMG
踜	RMGCE
踛	RMGCG
跱	RMGDI
跬	RMGG
蹺	RMGGU
躊	RMGNI
哢	RMGT
跿	RMGYO
踿	RMHDF
踒	RMHDV
蹯	RMHDW
路	RMHER
跣	RMHGU
蹓	RMHHW
跦	RMHJD
踵	RMHJG
??	RMHJU
蹻	RMHKB
踽	RMHLB
躓	RMHLC
嚦	RMHM
斲	RMHML
跅	RMHMY
跺	RMHND
蹤	RMHOO
跌	RMHQO
蹁	RMHSB
躈	RMHSK
躦	RMHUC
??	RMHYU
踉	RMIAV
踆	RMICE
咥	RMIG
躕	RMIGI
踐	RMII
??	RMIKE
跋	RMIKK
跆	RMIR
踱	RMITE
蹠	RMITF
躔	RMIWG
蹗	RMIXP
踮	RMIYR
蹎	RMJBC
??	RMJCO
躥	RMJCV
??	RMJD
跂	RMJE
??	RMJJ
噉	RMJK
踍	RMJKD
踕	RMJLO
蹤	RMJMF
踠	RMJNU
蹜	RMJOA
跎	RMJP
跍	RMJR
??	RMJX
??	RMK
踦	RMKMR
跨	RMKMS
跠	RMKN
蹛	RMKPB
跏	RMKSR
啢	RMLB
哽	RMLK
啞	RMLM
蹪	RMLMC
跳	RMLMO
跩	RMLWP
跴	RMMCW
趶	RMMD
躎	RMMFB
躕	RMMGI
跮	RMMIG
趼	RMMJJ
??	RMMMP
噁	RMMP
跖	RMMR
踾	RMMRW
趼	RMMT
蹶	RMMTO
??	RMMVM
叮	RMN
踴	RMNBS
??	RMNHB
蹂	RMNHD
趿	RMNHE
踊	RMNIB
跢	RMNIN
跪	RMNMU
咧	RMNN
蹳	RMNOE
蹬	RMNOT
呵	RMNR
跺	RMNSD
跗	RMODI
踓	RMOG
跈	RMOHH
??	RMOII
踗	RMOIP
蹌	RMOIR
踟	RMOKR
踚	RMOMB
跧	RMOMG
踰	RMOMN
跲	RMOMR
踰	RMOMV
趷	RMON
躌	RMOTQ
踇	RMOWY
踘	RMPFD
趵	RMPI
趵	RMPM
蹞	RMPMC
跑	RMPRU
跇	RMPT
蹀	RMPTD
踳	RMQKA
蹖	RMQKX
??	RMQMB
蹟	RMQMC
趺	RMQO
嗝	RMRB
躁	RMRRD
踀	RMRYO
踙	RMSJE
躡	RMSJJ
踞	RMSJR
踂	RMSJU
躍	RMSMG
啄	RMSO
跜	RMSP
距	RMSS
跼	RMSSR
蹍	RMSTV
呃	RMSU
跽	RMSUP
??	RMT
踖	RMTA
躪	RMTAG
??	RMTB
躨	RMTCE
蹼	RMTCO
躇	RMTJA
躑	RMTKL
蹣	RMTLB
踑	RMTMC
踸	RMTMV
噘	RMTO
躤	RMTQA
蹉	RMTQM
跰	RMTT
踫	RMTTC
??	RMTTM
蹧	RMTWA
蹲	RMTWI
噆	RMUA
蹦	RMUBB
嗄	RMUE
嘎	RMUI
踹	RMUMB
??	RMUOB
呀	RMVH
嗕	RMVI
躒	RMVID
躖	RMVIM
蹡	RMVMI
??	RMVN
躐	RMVVV
踝	RMWD
嘌	RMWF
喱	RMWG
嘾	RMWJ
喕	RMWL
躅	RMWLI
蹕	RMWTJ
喓	RMWV
??	RMY
踔	RMYAJ
??	RMYAV
蹄	RMYBB
躘	RMYBP
蹢	RMYCB
跤	RMYCK
嘕	RMYF
踧	RMYFE
蹴	RMYFU
跓	RMYG
躂	RMYGQ
??	RMYIU
蹥	RMYJJ
跡	RMYLC
踄	RMYLH
趾	RMYLM
跐	RMYMP
躚	RMYMU
踤	RMYOJ
躆	RMYPO
跕	RMYR
躟	RMYRV
踣	RMYTR
踥	RMYTV
躋	RMYX
唃	RNBG
嘝	RNBJ
喚	RNBK
??	RNCR
吇	RND
吼	RNDU
吜	RNG
噊	RNHB
吸	RNHE
啗	RNHX
??	RNII
哆	RNIN
唌	RNKM
啊	RNLR
吹	RNO
嚵	RNRI
嚕	RNWA
吶	ROB
咻	ROD
咐	RODI
唯	ROG
??	ROGF
嗿	ROIC
呤	ROII
吟	ROIN
唸	ROIP
嗆	ROIR
??	ROIV
吘	ROJ
??	ROK
吤	ROLL
噲	ROMA
??	ROMB
唋	ROMD
啣	ROML
喻	ROMN
噞	ROMO
哈	ROMR
喻	ROMV
吃	RON
喉	RONK
唑	ROOG
吪	ROP
哖	ROQ
??	RORM
啽	RORT
咋	ROS
咿	ROSK
嘸	ROTF
噙	ROYB
叱	RP
??	RPA
??	RPD
咇	RPH
??	RPHAF
吻	RPHH
唿	RPHP
??	RPHR
??	RPIM
??	RPLII
刡	RPLN
呁	RPMM
敃	RPOK
啕	RPOU
??	RPP
喈	RPPA
呴	RPR
咆	RPRU
??	RPSH
??	RPT
喋	RPTD
吨	RPU
噸	RPUC
哅	RPUK
啪	RQHA
??	RQHF
喫	RQHK
哳	RQHL
囓	RQHU
??	RQHV
嘒	RQJM
??	RQJP
唪	RQKQ
嘖	RQMC
嗉	RQMF
咑	RQMN
??	RQSR
啦	RQYT
??	RR
唈	RRAU
斝	RRBYJ
喣	RRF
鷺	RRHAF
咒	RRHN
咒	RRHU
哭	RRIK
器	RRIKR
喌	RRILL
??	RRILR
囂	RRMCR
??	RRMJS
嚴	RRMMK
咢	RRMMS
??	RRMNR
呺	RRMS
郘	RRNL
品	RRR
噪	RRRD
嘽	RRRJ
碞	RRRR
喦	RRRU
嚚	RRSLR
噀	RRUC
嘂	RRVLR
呡	RRVP
單	RRWJ
鼉	RRWMU
哫	RRYO
唰	RSBN
囑	RSEI
叨	RSH
鶚	RSHAF
??	RSHX
嚂	RSIT
咠	RSJ
囁	RSJJ
??	RSK
叩	RSL
咂	RSLB
別	RSLN
叼	RSM
顎	RSMBC
唚	RSME
嚁	RSMG
嘐	RSMH
噚	RSMI
噿	RSMJ
嚂	RSMT
鄂	RSNL
呎	RSO
??	RSOIV
呢	RSP
??	RSPRU
嗎	RSQF
哪	RSQL
??	RSRG
嘔	RSRR
叚	RSSE
啒	RSUU
號	RSYPU
唶	RTA
嗼	RTAK
噶	RTAV
??	RTAW
哄	RTC
??	RTCH
嘶	RTCL
噗	RTCO
嗌	RTCT
囈	RTGI
??	RTGK
唴	RTGU
哎	RTK
喏	RTKR
嚥	RTLF
??	RTLK
嘆	RTLO
咁	RTM
唭	RTMC
嘩	RTMJ
啿	RTMV
囌	RTND
嗏	RTOD
嚄	RTOE
??	RTON
嗒	RTOR
咩	RTQ
嗟	RTQM
嚾	RTRG
嗍	RTUB
??	RTUI
喵	RTW
嘈	RTWA
噂	RTWI
噥	RTWV
嗛	RTXC
嚆	RTYB
巳	RU
喘	RUMB
嗤	RUMI
鄳	RUNL
嗺	RUOG
饕	RUOIV
巽	RUTC
咄	RUU
呶	RVE
喲	RVFI
吆	RVI
嘰	RVII
呦	RVIS
叫	RVL
吳	RVNK
喙	RVNO
民	RVP
嗈	RVVU
喟	RWB
呬	RWC
哩	RWG
嘿	RWGF
嚜	RWGG
??	RWGN
嘓	RWIM
咽	RWK
嗯	RWKP
呷	RWL
喁	RWLB
嘪	RWLC
囉	RWLG
噣	RWLI
噮	RWLV
喂	RWMV
鄙	RWNL
嗢	RWOT
嗶	RWTJ
呣	RWYI
黽	RXU
啅	RYAJ
噷	RYAO
啼	RYBB
??	RYBC
嚨	RYBP
嗙	RYBS
嘀	RYCB
咬	RYCK
囃	RYDG
??	RYDK
嚫	RYDU
噈	RYFU
噠	RYGQ
嚬	RYHC
喭	RYHH
吭	RYHN
唷	RYIB
??	RYJ
嗹	RYJJ
呅	RYK
喭	RYKH
啃	RYMB
噦	RYMH
呲	RYMP
唁	RYMR
嚙	RYMU
足	RYO
啐	RYOJ
嘴	RYPB
??	RYPD
噳	RYPK
噓	RYPM
唬	RYPN
噱	RYPO
嚧	RYPT
唬	RYPU
呫	RYR
嗃	RYRB
啍	RYRD
哼	RYRN
嚎	RYRO
喨	RYRU
嚷	RYRV
嗾	RYSK
唹	RYSY
喑	RYTA
??	RYTJ
噫	RYTP
唼	RYTV
噰	RYVG
咳	RYVO
??	RYVQ
嚃	RYWE
??	RYWO
嚌	RYX
尸	S
鷵	SAHAF
飁	SAHNI
翫	SAMMU
匽	SAV
屭	SBCC
朢	SBHG
刷	SBLN
匷	SBUG
匹	SC
鴄	SCHAF
殿	SCHNE
層	SCWA
尿	SE
腎	SEB
賢	SEBUC
鋻	SEC
棸	SED
焣	SEF
堅	SEG
鷖	SEHAF
聚	SEHHO
犀	SEHQ
蜸	SELMI
醫	SEMCW
瑿	SEMGI
毉	SEMOO
硻	SEMR
豎	SEMRT
匯	SEOG
聚	SEOOO
掔	SEQ
翳	SESMM
娶	SEV
緊	SEVIF
黳	SEWGF
屬	SEWI
??	SEYMR
??	SEYT
馹	SFA
騴	SFAJV
駻	SFAMJ
騠	SFAMO
騉	SFAPP
騔	SFAPV
屑	SFB
騧	SFBBR
騆	SFBGR
駔	SFBM
駧	SFBMR
??	SFBQR
駉	SFBR
騱	SFBVK
駾	SFCRU
驓	SFCWA
屎	SFD
尉	SFDI
駃	SFDK
駷	SFDL
騋	SFDOO
馭	SFE
騷	SFEII
驎	SFFDQ
??	SFFMU
??	SFFQF
驍	SFGGU
騜	SFHAG
騬	SFHDP
駱	SFHER
駪	SFHGU
??	SFHHL
騮	SFHHW
??	SFHJD
驕	SFHKB
??	SFHML
颿	SFHNI
馲	SFHP
??	SFHS
騙	SFHSB
騸	SFHSM
騩	SFHUI
驄	SFHWP
騪	SFHXE
駺	SFIAV
駿	SFICE
馻	SFIHU
驂	SFIIH
駥	SFIJ
騃	SFIOK
駘	SFIR
駴	SFIT
駹	SFIUH
驖	SFJIG
驞	SFJMC
??	SFJMF
駝	SFJP
??	SFJV
馱	SFK
駁	SFKK
??	SFKKK
騎	SFKMR
馽	SFL
??	SFLE
駛	SFLK
馴	SFLLL
??	SFLMC
駣	SFLMO
騑	SFLMY
驥	SFLPC
駎	SFLW
騁	SFLWS
驌	SFLX
驦	SFMBU
駍	SFMFJ
駓	SFMFM
騵	SFMHF
駤	SFMIG
馯	SFMJ
驪	SFMMP
??	SFMR
驃	SFMWF
驔	SFMWJ
騕	SFMWV
驈	SFNHB
騥	SFNHD
馺	SFNHE
??	SFNKM
騝	SFNKQ
騤	SFNOK
騛	SFNOO
駙	SFODI
騅	SFOG
駗	SFOHH
駖	SFOII
駇	SFOK
駼	SFOMD
駩	SFOMG
驗	SFOMO
騇	SFOMR
??	SFPA
馳	SFPD
駜	SFPH
馰	SFPI
??	SFPM
騊	SFPOU
駒	SFPR
騶	SFPUU
騞	SFQJR
駽	SFRB
驒	SFRRJ
騢	SFRSE
驟	SFSEO
驫	SFSFF
駋	SFSHR
駬	SFSJ
??	SFSJR
騽	SFSMA
??	SFSMC
駸	SFSME
驏	SFSND
??	SFSO
驅	SFSRR
駏	SFSS
駶	SFSSR
馵	SFT
騲	SFTAJ
騚	SFTBN
??	SFTGI
驧	SFTJD
驠	SFTLF
騹	SFTLM
騏	SFTMC
驊	SFTMJ
驩	SFTRG
駢	SFTT
騣	SFUCE
驨	SFUOB
騄	SFVNE
駟	SFWC
騍	SFWD
駰	SFWK
驛	SFWLJ
??	SFWP
??	SFWTC
驆	SFWTJ
騾	SFWVF
??	SFYBS
駮	SFYCK
驐	SFYDK
駐	SFYG
褧	SFYHV
??	SFYK
??	SFYLB
??	SFYOJ
驉	SFYPM
驢	SFYPT
驤	SFYRV
騿	SFYTJ
駭	SFYVO
驙	SFYWM
鸐	SGHAF
戳	SGI
聽	SGJWP
劻	SGKS
剭	SGLN
??	SGNL
??	SGWC
刀	SH
鳲	SHAF
兔	SHAHI
??	SHANA
鬄	SHAPH
鬘	SHAWE
鬅	SHBB
??	SHBD
??	SHBMM
??	SHBSD
匴	SHBT
負	SHBUC
??	SHCNH
鬙	SHCWA
??	SHD
鬎	SHDBN
鬆	SHDCI
髲	SHDHE
瘌	SHDLN
??	SHDOE
??	SHEFH
髾	SHFB
??	SHFMU
鬈	SHFQU
髯	SHGB
髻	SHGR
鷚	SHHAF
??	SHHDA
鬁	SHHDN
??	SHHDV
??	SHHE
髼	SHHEJ
鬚	SHHHC
髺	SHHJR
髡	SHHN
髦	SHHQU
??	SHHYE
刃	SHI
鬖	SHIIH
??	SHIKE
??	SHIKH
髮	SHIKK
鬒	SHJBC
??	SHJBM
??	SHJD
鬢	SHJMC
鬃	SHJMF
鬐	SHJPA
??	SHJR
鬍	SHJRB
髮	SHKE
??	SHKHF
鬌	SHKMB
??	SHKS
??	SHLB
髧	SHLBU
彿	SHLLN
??	SHLMC
??	SHLN
顟	SHMBC
??	SHMBL
??	SHMF
髬	SHMFM
??	SHMJR
匠	SHML
??	SHMR
??	SHMRW
髡	SHMU
??	SHMYS
髳	SHNIH
鄝	SHNL
屩	SHOB
髹	SHOD
履	SHOE
雡	SHOG
??	SHOIM
??	SHOLL
鬠	SHOMA
??	SHOMC
屣	SHOO
髽	SHOOG
屜	SHOT
屨	SHOV
??	SHPD
髱	SHPRU
鬊	SHQKA
尾	SHQU
召	SHR
匾	SHSB
髫	SHSHR
髶	SHSJ
鬕	SHTAK
鬋	SHTBN
??	SHTC
鬗	SHTLB
髷	SHTW
鬞	SHTWV
鬑	SHTXC
??	SHUCE
鬣	SHVVV
鬟	SHWLV
??	SHWP
??	SHYHJ
髣	SHYHS
髭	SHYMP
??	SHYR
鬤	SHYRV
監	SIBT
熨	SIF
髟	SIHHH
镺	SIHK
斸	SIHML
犚	SIHQ
镻	SIHQO
镽	SIKCF
??	SILMI
??	SILN
肆	SILQ
鄩	SINL
忍	SIP
镼	SISUU
??	SITOE
褽	SIYHV
耳	SJ
??	SJANA
臂	SJB
??	SJBSD
屄	SJC
聬	SJCIM
??	SJCMS
??	SJCSH
檗	SJD
取	SJE
郰	SJENL
耿	SJF
糪	SJFD
??	SJFDQ
壁	SJG
聃	SJGB
??	SJGDI
聐	SJGR
鷿	SJHAF
??	SJHBY
聊	SJHHL
聒	SJHJR
??	SJHJX
??	SJHQI
毦	SJHQU
??	SJHUP
??	SJHWJ
聰	SJHWP
??	SJHWS
??	SJHXE
??	SJHXU
??	SJIR
聝	SJIRM
??	SJJBF
聜	SJJCM
??	SJJMO
匭	SJJN
聹	SJJPN
屠	SJKA
屪	SJKF
耾	SJKI
??	SJKMS
??	SJKN
??	SJKS
幦	SJLB
耽	SJLBU
聵	SJLMC
??	SJLMY
刵	SJLN
聘	SJLWS
顳	SJMBC
聏	SJMBL
璧	SJMGI
??	SJMJK
??	SJMJR
??	SJMJX
??	SJMMP
耵	SJMN
??	SJMR
甓	SJMVN
聇	SJMYM
聸	SJNCR
耶	SJNL
聧	SJNOK
聆	SJOII
耹	SJOIN
??	SJORM
恥	SJP
??	SJPKP
擘	SJQ
居	SJR
??	SJRSE
鼊	SJRXU
躄	SJRYO
劈	SJSH
聑	SJSJ
聶	SJSJJ
耴	SJU
嬖	SJV
繴	SJVIF
??	SJVII
聈	SJVIS
聯	SJVIT
??	SJWD
襞	SJYHV
職	SJYIA
恥	SJYLM
譬	SJYMR
聤	SJYRN
??	SJYTG
尹	SK
尻	SKN
??	SKP
君	SKR
卩	SL
匝	SLB
屢	SLLV
頤	SLMBC
匱	SLMC
匪	SLMY
臥	SLO
臨	SLORR
賾	SLQMC
臣	SLSL
臦	SLSLL
??	SLVIF
??	SLW
臥	SLY
刁	SM
翨	SMAMO
翬	SMBJJ
帚	SMBLB
監	SMBT
??	SMC
翂	SMCSH
翍	SMDHE
??	SMFDH
匡	SMG
習	SMHA
翵	SMHAF
翐	SMHQO
毣	SMHQU
屋	SMIG
翇	SMIKK
翜	SMKOO
翀	SML
羾	SMM
頨	SMMBC
??	SMMG
尋	SMMRI
屍	SMNP
??	SMOB
翟	SMOG
翏	SMOHH
??	SMOIN
翭	SMONK
翑	SMPR
司	SMR
羽	SMSIM
羿	SMT
翪	SMUCE
長	SMV
翼	SMWTC
翴	SMYJJ
??	SMYK
翠	SMYOJ
翯	SMYRB
翞	SMYRF
翌	SMYT
翣	SMYTV
孱	SNDD
??	SNKG
屙	SNLR
尺	SO
??	SOG
??	SOMO
匼	SOMR
鄹	SONL
??	SOOG
咫	SORC
尼	SP
??	SPBUC
匜	SPD
鵋	SPHAF
匢	SPHH
屁	SPP
??	SPT
那	SQNL
馬	SQSF
叵	SR
盬	SRBT
覗	SRBUU
??	SRDI
??	SRE
焄	SRF
鷗	SRHAF
聖	SRHG
毆	SRHNE
劭	SRKS
屌	SRLB
??	SRLN
頵	SRMBC
甌	SRMVN
??	SRND
郡	SRNL
歐	SRNO
慝	SRP
匰	SRRJ
區	SRRR
卲	SRSL
??	SRSU
??	SRTLM
群	SRTQ
敺	SRYE
辟	SRYTJ
巨	SS
燛	SSF
臩	SSKLL
螶	SSLII
局	SSR
凹	SSU
兕	SSUU
匿	STKR
??	STQ
羼	STQQ
屏	STT
展	STV
己	SU
??	SUD
??	SUDM
熙	SUF
屆	SUG
鶌	SUHAF
??	SULMY
屘	SUND
邔	SUNL
改	SUOK
忌	SUP
异	SUT
屈	SUU
媐	SUV
鶠	SVHAF
??	SVMB
郾	SVNL
??	SVSMV
屇	SW
鹽	SWBT
覽	SWBUU
鑒	SWC
匣	SWL
??	SWQ
??	SXFF
??	SXNO
匟	SYHN
屏	SYJJ
屖	SYTJ
廿	T
昔	TA
菖	TAA
萌	TAB
萺	TABU
皵	TADHE
蒔	TAGI
鵲	TAHAF
斮	TAHML
??	TAIL
蔇	TAIU
草	TAJ
莫	TAK
暮	TAKA
幕	TAKB
驀	TAKF
墓	TAKG
??	TAKI
慕	TAKP
摹	TAKQ
募	TAKS
??	TALK
剒	TALN
??	TAMO
菛	TAN
??	TANA
蕑	TANB
藺	TANG
蕄	TANP
??	TANR
??	TANV
蘭	TANW
??	TAOG
葃	TAOS
菎	TAPP
葛	TAPV
??	TARF
蕞	TASE
芭	TAU
茛	TAV
蔓	TAWE
蓂	TBAC
萉	TBAU
??	TBB
蓇	TBBB
薆	TBBE
蕣	TBBQ
萵	TBBR
薍	TBBU
覯	TBBUU
典	TBC
萴	TBCN
黺	TBCSH
蘡	TBCV
菜	TBD
??	TBDH
??	TBDK
藤	TBFE
??	TBFR
??	TBFS
塑	TBG
??	TBHD
蒍	TBHF
薶	TBHG
藐	TBHU
??	TBHW
??	TBHX
黼	TBIJB
黻	TBIKK
葷	TBJJ
勱	TBKS
繭	TBLI
前	TBLN
苴	TBM
顜	TBMBC
萲	TBME
蒙	TBMO
茼	TBMR
莇	TBMS
蒏	TBMW
莩	TBND
煎	TBNF
剪	TBNH
蒬	TBNI
翦	TBNM
蔡	TBOF
散	TBOK
葄	TBOS
愬	TBP
葋	TBPR
菔	TBSE
菵	TBTV
苜	TBU
蔝	TBUD
??	TBUF
藈	TBUK
薡	TBUL
萛	TBUT
莧	TBUU
荽	TBV
??	TBVG
斠	TBYJ
共	TC
普	TCA
期	TCB
益	TCBT
腆	TCBUU
??	TCE
黹	TCFB
基	TCG
鶼	TCHAF
??	TCHB
夔	TCHE
斯	TCHML
??	TCHNI
蓊	TCIM
輂	TCJWJ
蛬	TCLMI
碁	TCMR
欺	TCNO
恭	TCP
拲	TCQ
巷	TCRU
棻	TCSD
芬	TCSH
葐	TCST
巷	TCSU
業	TCTD
叢	TCTE
綦	TCVIF
酋	TCWM
黈	TCYG
斢	TCYJ
諅	TCYMR
??	TD
??	TDA
??	TDAB
茦	TDB
蕀	TDBB
蓛	TDBK
莿	TDBN
??	TDBO
??	TDBR
葙	TDBU
菘	TDCI
菻	TDD
??	TDGF
??	TDHAF
??	TDHE
菥	TDHL
茉	TDJ
芵	TDK
藾	TDLC
蔌	TDLO
苯	TDM
葦	TDMQ
鄴	TDNL
??	TDOI
萊	TDOO
??	TDOP
??	TDQT
莕	TDR
藲	TDSR
菄	TDW
萰	TDWF
??	TE
蕩	TEAH
薀	TEAT
菹	TEBM
鑿	TEC
莯	TED
菠	TEDE
??	TEED
??	TEFD
莎	TEFH
蔆	TEGE
??	TEHA
落	TEHR
蒎	TEHV
藩	TEHW
蒲	TEIB
薄	TEII
??	TEIR
蒗	TEIV
??	TEJR
??	TELL
??	TELQ
莐	TELU
茳	TEM
薸	TEMF
萍	TEMJ
菏	TEMR
莈	TENE
蒤	TEOD
??	TEOG
虃	TEOM
蕍	TEON
??	TEOR
蒞	TEOT
??	TEOV
??	TEQB
藻	TERD
蕖	TESD
菬	TESR
菃	TESS
范	TESU
??	TETC
??	TETI
蓱	TETT
??	TEVD
蕅	TEWB
薀	TEWT
薃	TEYB
蔋	TEYE
??	TEYM
蒞	TEYT
蓅	TEYU
茫	TEYV
苂	TF
蔊	TFAJ
莦	TFB
蔽	TFBK
萷	TFBN
菼	TFF
藀	TFFF
??	TFHF
??	TFHK
??	TFHT
??	TFKB
蘱	TFKC
虌	TFKU
薠	TFMC
茪	TFMU
酀	TFNL
菤	TFQU
??	TFYJ
芏	TG
??	TGAJ
苒	TGB
蓋	TGBT
觀	TGBUU
菱	TGCE
對	TGDI
羨	TGENO
羔	TGF
??	TGFBT
羹	TGFTK
茥	TGG
葑	TGGI
蕘	TGGU
鸛	TGHAF
羲	TGHDS
飌	TGHNI
義	TGHQI
羌	TGHU
爇	TGIF
??	TGIG
藝	TGII
羨	TGIMO
羕	TGINE
蓋	TGIT
蕔	TGJE
蓻	TGJI
美	TGK
勸	TGKS
羛	TGLLN
顴	TGMBC
??	TGMMO
薵	TGNI
酄	TGNL
歡	TGNO
??	TGOB
臡	TGOBO
??	TGOR
薔	TGOW
恙	TGP
荺	TGPM
薹	TGRG
蔜	TGSK
薣	TGTE
善	TGTR
姜	TGV
藚	TGWC
蘾	TGYV
??	THAE
蔦	THAF
葟	THAG
菂	THAI
葩	THAU
??	THBC
虋	THBH
薁	THBK
首	THBU
藰	THCN
萫	THDA
蕱	THDB
薐	THDE
萩	THDF
蕛	THDH
蒩	THDM
莉	THDN
??	THDP
??	THDR
莠	THDS
萎	THDV
蕃	THDW
??	THED
??	THEJ
茖	THER
苳	THEY
??	THFD
??	THG
薰	THGF
鶜	THHAF
蕦	THHC
藜	THHD
藜	THHE
茆	THHL
芊	THJ
茱	THJD
葮	THJE
董	THJG
菙	THJM
芺	THK
蕎	THKB
菾	THKP
萭	THLB
蘌	THLF
蘬	THMB
芹	THML
茩	THMR
??	THMY
藜	THND
芟	THNE
??	THNF
芃	THNI
??	THOD
蕧	THOE
??	THOI
薇	THOK
蓹	THOL
荇	THON
蓯	THOO
葎	THOQ
莪	THQI
??	THQM
苵	THQO
芼	THQU
薛	THRJ
??	THS
萹	THSB
蒑	THSE
??	THSF
薂	THSK
蔰	THSU
??	THUC
蒐	THUI
蒠	THUP
蘶	THVI
??	THVO
??	THVP
萆	THWJ
蔥	THWP
藇	THXC
??	THXE
蕮	THXF
萸	THXO
蒰	THYE
莨	TIAV
蒪	TIBI
荾	TICE
藦	TICQ
蘑	TICR
蘼	TICY
麻	TIDD
藦	TIDQ
蘑	TIDR
蘼	TIDY
茂	TIH
鷷	TIHAF
蕆	TIHC
??	TIHE
菧	TIHM
葴	TIHR
荿	TIHS
葳	TIHV
??	TII
??	TIIB
蔘	TIIH
??	TIIK
??	TIIL
茙	TIJ
莆	TIJB
麻	TIJC
莍	TIJE
??	TIKE
蒍	TIKF
茇	TIKK
莽	TIKT
??	TIKU
菮	TILO
蓎	TILR
茨	TIMO
藏	TIMS
??	TINE
芝	TINO
薋	TIOC
??	TIOP
懟	TIP
蘪	TIPD
藨	TIPF
苔	TIR
??	TIST
蓆	TITB
薕	TITC
蔗	TITF
薦	TIXF
蔍	TIXP
??	TIYL
卅	TJ
靼	TJAM
鞮	TJAMO
鞨	TJAPV
靶	TJAU
鞎	TJAV
韅	TJAVF
芾	TJB
??	TJBC
荸	TJBD
??	TJBHX
萳	TJBJ
靻	TJBM
葖	TJCK
藭	TJCN
蓉	TJCR
??	TJD
鞁	TJDHE
靺	TJDJ
葧	TJDS
芰	TJE
鞜	TJEA
蘻	TJEF
鞘	TJFB
鞝	TJFBR
??	TJFD
靽	TJFQ
鞋	TJGG
鞊	TJGR
韇	TJGWC
鷨	TJHAF
鞂	TJHD
鞦	TJHDF
??	TJHF
靳	TJHML
鞞	TJHWJ
蓴	TJII
蕙	TJIP
??	TJIXF
鞚	TJJCM
蓒	TJJJ
蔪	TJJL
鞍	TJJV
著	TJKA
??	TJKF
荖	TJKP
勒	TJKS
鞅	TJLBK
鞻	TJLLV
??	TJLMO
萐	TJLO
萋	TJLV
蔩	TJMC
蔻	TJME
??	TJMF
??	TJMI
靬	TJMJ
萱	TJMM
靪	TJMN
萣	TJMO
菪	TJMR
靰	TJMU
韁	TJMWM
鞔	TJNAU
孽	TJND
鞣	TJNHD
靸	TJNHE
鞃	TJNI
鞬	TJNKQ
靷	TJNL
菀	TJNU
蓿	TJOA
靲	TJOIN
鞭	TJOMK
鞈	TJOMR
??	TJONK
靴	TJOP
鞥	TJORT
蓍	TJPA
鞠	TJPFD
靮	TJPI
靮	TJPM
薴	TJPN
鞄	TJPRU
靾	TJPT
鞢	TJPTD
蔤	TJPU
鞫	TJPYR
鞡	TJQYT
苦	TJR
葫	TJRB
菅	TJRR
躠	TJRYO
韌	TJSHI
鞀	TJSHR
蕡	TJTC
韉	TJTIF
??	TJTMJ
韄	TJTOE
鞳	TJTOR
藆	TJTQ
荌	TJV
鞿	TJVII
靿	TJVIS
莗	TJWJ
??	TJWTJ
鞹	TJYDL
韃	TJYGQ
韆	TJYMU
??	TJYRD
??	TJYTR
艾	TK
蔱	TKCE
檠	TKD
??	TKDE
苃	TKE
鶧	TKHAF
荻	TKHF
莥	TKHG
藱	TKHI
蕕	TKHW
??	TKIT
莃	TKKB
荐	TKLD
茬	TKLG
蟼	TKLMI
菴	TKLU
??	TKMR
荂	TKMS
荑	TKN
芄	TKNI
鄭	TKNL
蒺	TKOK
莢	TKOO
憼	TKP
蔕	TKPB
擎	TKQ
若	TKR
惹	TKRP
??	TKRU
驚	TKSQF
茄	TKSR
荔	TKSS
警	TKYMR
英	TLBK
??	TLD
??	TLII
革	TLJ
??	TLKY
蟴	TLLMI
茀	TLLN
蔞	TLLV
蕢	TLMC
茧	TLMI
藎	TLMT
菲	TLMY
燕	TLPF
??	TLPV
堇	TLQM
韭	TLSM
藪	TLVK
苖	TLW
黃	TLWC
蕭	TLX
甘	TM
普	TMA
荁	TMAM
薷	TMBB
??	TMBF
藿	TMBG
蕓	TMBI
荋	TMBL
蘦	TMBR
覲	TMBUU
蕾	TMBW
??	TMCE
茜	TMCW
某	TMD
芣	TMF
薾	TMFB
蒜	TMFF
苹	TMFJ
苤	TMFM
??	TMG
蘸	TMGF
??	TMGI
菿	TMGN
蘁	TMGR
蒝	TMHF
蕥	TMHG
藶	TMHM
斳	TMHML
??	TMHN
荎	TMIG
??	TMJJ
荊	TMJN
菾	TMKP
勤	TMKS
??	TMLK
??	TMLM
其	TMMC
??	TMMF
芸	TMMI
??	TMMM
茨	TMMO
葝	TMMS
芫	TMMU
甚	TMMV
艼	TMN
薚	TMNH
茿	TMNJ
邯	TMNL
薤	TMNM
茢	TMNN
苛	TMNR
蒆	TMNV
??	TMNY
藸	TMOA
苪	TMOB
??	TMOC
蕤	TMOM
莁	TMOO
葬	TMPT
蒚	TMRB
藞	TMRR
荳	TMRT
葍	TMRW
??	TMT
華	TMTJ
荊	TMTN
蕨	TMTO
??	TMUA
芽	TMVH
蓐	TMVI
莖	TMVM
蔈	TMWF
蕈	TMWJ
??	TMWL
薑	TMWM
??	TMWU
葽	TMWV
芐	TMY
蔫	TMYF
齹	TMYMU
芎	TN
菟	TNAI
萯	TNBC
藑	TNBE
薢	TNBQ
薝	TNCR
芓	TND
蓀	TNDF
菰	TNDO
芤	TNDU
蒸	TNEF
蘇	TNFD
薊	TNFN
蘚	TNFQ
??	TNG
葇	TNHD
芨	TNHE
艿	TNHS
萏	TNHX
苰	TNI
茅	TNIH
??	TNIL
芧	TNIN
荈	TNIQ
茗	TNIR
苑	TNIU
蕵	TNIV
莛	TNKG
莚	TNKM
藬	TNLC
蒢	TNLD
??	TNLH
蔭	TNLI
薩	TNLM
蘟	TNLP
??	TNLU
蔯	TNLW
??	TNML
蒻	TNMM
蔬	TNMU
蕷	TNNC
鄸	TNNL
??	TNNO
芡	TNO
??	TNOE
葵	TNOK
葞	TNSJ
虇	TNTG
葾	TNUP
葂	TNUS
艱	TOAV
芮	TOB
蒮	TOBG
茶	TOD
苻	TODI
??	TODV
苶	TOF
萑	TOG
蕉	TOGF
??	TOGG
舊	TOGX
鸏	TOHAF
荏	TOHG
??	TOHN
氋	TOHQU
茷	TOI
養	TOIAV
葰	TOIE
苓	TOII
茯	TOIK
芩	TOIN
??	TOIP
蒼	TOIR
蘩	TOKF
薙	TOKG
蓨	TOLB
蓧	TOLD
??	TOLH
??	TOLK
芥	TOLL
薈	TOMA
菕	TOMB
荼	TOMD
荃	TOMG
芢	TOMM
??	TOMN
薟	TOMO
荷	TOMR
葔	TONK
歎	TONO
鯗	TONWF
蓌	TOOE
難	TOOG
蘞	TOOK
葅	TOOM
??	TOOO
莋	TOOS
花	TOP
??	TOQ
蒨	TOQB
葆	TORD
??	TORE
??	TORT
苲	TOS
??	TOSB
葠	TOSE
??	TOSJ
蕪	TOTF
??	TOU
蒛	TOUK
莓	TOWY
??	TOYM
蓓	TOYR
蒞	TOYT
芯	TP
荀	TPA
菊	TPFD
苾	TPH
芴	TPHH
芍	TPI
葡	TPIB
??	TPKK
薿	TPKO
蔥	TPKP
芍	TPM
蔔	TPMW
萄	TPOU
芘	TPP
??	TPPD
蕊	TPPP
苟	TPR
苞	TPRU
葉	TPTD
芚	TPU
??	TPUU
蘹	TPYV
羊	TQ
羯	TQAPV
著	TQBU
羒	TQCSH
藉	TQDA
藕	TQDB
??	TQDT
??	TQE
莏	TQFH
??	TQHAF
羳	TQHDW
??	TQHE
羖	TQHNE
羝	TQHPM
葀	TQHR
蒱	TQIB
羧	TQICE
羬	TQIHR
羢	TQIJ
菝	TQIK
羻	TQIXE
蔧	TQJM
羜	TQJMN
羦	TQJMU
羵	TQJTC
萶	TQKA
蓁	TQKD
羠	TQKN
菶	TQKQ
菗	TQLW
差	TQM
菁	TQMB
羺	TQMBB
??	TQMF
羱	TQMHF
羥	TQMVM
羞	TQNG
芙	TQO
蓷	TQOG
羚	TQOII
羭	TQOMN
羷	TQOMO
??	TQOMV
恙	TQP
菢	TQPU
荴	TQQO
翔	TQSMM
??	TQSR
??	TQTQQ
羰	TQUMF
蘀	TQWJ
??	TQYRR
菈	TQYT
羶	TQYWM
??	TRBC
莒	TRHR
菋	TRJD
蕺	TRJI
蘄	TRJL
??	TRLN
??	TRLR
蕗	TRMR
鄯	TRNL
??	TRNO
蓶	TROG
敬	TROK
荶	TRON
??	TRRD
雚	TRRG
蕇	TRRJ
虈	TRRR
萼	TRRS
葭	TRSE
葺	TRSJ
??	TRU
苠	TRVP
??	TSEF
蘙	TSEM
藂	TSEO
蔚	TSFI
芀	TSH
??	TSHC
??	TSHI
苕	TSHR
萏	TSHX
蕻	TSIC
荵	TSIP
蕼	TSIQ
藍	TSIT
茸	TSJ
蘵	TSJA
蘗	TSJD
菆	TSJE
??	TSJP
芛	TSK
莙	TSKR
菣	TSLE
茞	TSLL
??	TSLY
藋	TSMG
蓼	TSMH
蕁	TSMI
??	TSMJ
藍	TSMT
萇	TSMV
懃	TSP
??	TSQL
蔒	TSRF
薜	TSRJ
蓲	TSRR
苣	TSS
??	TSTV
芑	TSU
井	TT
葥	TTBN
並	TTC
藄	TTCF
蘣	TTCG
??	TTE
??	TTG
冓	TTGB
蓔	TTGF
薱	TTGI
??	TTGP
??	TTGV
鷁	TTHAF
丼	TTI
蘜	TTJD
??	TTJL
??	TTLC
蓳	TTLM
荊	TTLN
並	TTM
頩	TTMBC
萁	TTMC
??	TTMS
葚	TTMV
瓶	TTMVN
豔	TTNAU
郱	TTNL
??	TTOM
蒫	TTQM
善	TTR
??	TTRAU
??	TTSHI
??	TTSP
荓	TTT
蒴	TTUB
蘛	TTVB
??	TTVP
蠲	TTWLI
蒹	TTXC
朔	TUB
??	TUI
馘	TUIRM
蘴	TUJT
菡	TUNE
茁	TUU
??	TVFE
蕬	TVFF
蒶	TVFH
葯	TVFI
??	TVFJ
葒	TVFM
蘊	TVFT
蕝	TVFU
蔠	TVFY
薌	TVHL
戡	TVI
藥	TVID
鶿	TVIF
茲	TVII
??	TVIN
苡	TVIO
慈	TVIP
苭	TVIS
??	TVIT
菇	TVJR
勘	TVKS
荍	TVLK
莊	TVMG
蔣	TVMI
蘠	TVMW
菉	TVNE
??	TVNIN
歁	TVNO
茹	TVR
蕠	TVRF
蒘	TVRQ
葌	TVVV
菑	TVVW
斟	TVYJ
苗	TW
曹	TWA
蠆	TWBI
躉	TWBO
莔	TWCB
果	TWD
尊	TWDI
蔨	TWFU
??	TWGV
菌	TWHD
猷	TWIK
蔮	TWIM
奠	TWK
莮	TWKS
薯	TWLA
萬	TWLB
蘉	TWLE
蘿	TWLG
蔑	TWLI
蠤	TWLII
夢	TWLN
薨	TWLP
瞢	TWLU
??	TWMF
農	TWMMV
豊	TWMRT
葨	TWMV
苬	TWO
葸	TWP
茴	TWR
蓽	TWTJ
蔂	TWVF
虆	TWWF
蘲	TWWG
??	TWWU
藟	TWWW
苺	TWYI
兼	TXC
蒂	TYBB
蘺	TYBG
藃	TYBO
蘢	TYBP
蒡	TYBS
蔏	TYCB
茭	TYCK
萒	TYCU
蔉	TYCV
薪	TYDL
??	TYDO
藽	TYDU
??	TYED
菽	TYFE
薘	TYGQ
薳	TYGV
蘋	TYHC
蓬	TYHJ
??	TYHL
苀	TYHN
芳	TYHS
??	TYHV
??	TYIF
茺	TYIU
蓮	TYJJ
芠	TYK
芷	TYLM
??	TYMD
薉	TYMH
??	TYMM
蓫	TYMO
茈	TYMP
蓪	TYNB
藙	TYOE
萃	TYOJ
蔖	TYPM
藘	TYPP
蘆	TYPT
苫	TYR
藷	TYRA
蒿	TYRB
??	TYRD
??	TYRE
蔀	TYRL
??	TYRM
葶	TYRN
薧	TYRP
蘘	TYRV
葹	TYSD
蔟	TYSK
??	TYSL
虀	TYSM
蔙	TYSO
菸	TYSY
苙	TYT
萻	TYTA
蕫	TYTG
莘	TYTJ
薏	TYTP
菩	TYTR
菨	TYTV
芒	TYV
蕹	TYVG
荄	TYVO
莣	TYVP
荒	TYVU
蓄	TYVW
蓾	TYWI
蓑	TYWV
薺	TYX
藡	TYYB
蘧	TYYO
山	U
??	UAHL
嵋	UAHU
崵	UAMH
崼	UAMO
崑	UAPP
嵑	UAPV
峎	UAV
??	UB
崩	UBB
崱	UBCN
??	UBCV
??	UBJJ
剬	UBLN
岨	UBM
顓	UBMBC
峒	UBMR
酅	UBNL
歂	UBNO
崢	UBSD
崗	UBTU
峴	UBUU
崟	UC
??	UCHB
嶔	UCNO
峪	UCOR
??	UCSH
嶒	UCWA
??	UDA
崧	UDCI
??	UDD
??	UDG
??	UDGG
岥	UDHE
??	UDHL
??	UDII
??	UDM
崍	UDOO
糶	UDSMG
崠	UDW
嵀	UDYG
??	UE
??	UEG
顄	UEMBC
峭	UFB
嶙	UFDQ
嶸	UFFD
巆	UFFR
嶗	UFFS
巀	UFGI
??	UFH
??	UFOG
??	UFSU
??	UG
崚	UGCE
峙	UGDI
崶	UGGI
嶢	UGGU
??	UGNI
崁	UGNO
匕	UH
岶	UHA
??	UHAF
崲	UHAG
??	UHAU
嵙	UHDJ
嵊	UHDP
崣	UHDV
嶓	UHDW
??	UHE
峰	UHEJ
??	UHEQ
峉	UHER
??	UHHE
嵧	UHHW
岆	UHK
嶠	UHKB
巋	UHMB
岓	UHML
嵐	UHNI
??	UHOI
??	UHOK
嵷	UHOO
嵂	UHOQ
崏	UHPA
峨	UHQI
嵨	UHRF
嶭	UHRJ
巑	UHUC
嵲	UHUD
嵬	UHUI
巍	UHVI
崥	UHWJ
嶼	UHXC
崀	UIAV
峻	UICE
??	UIHH
嵅	UIHR
??	UIHS
崴	UIHV
嵾	UIIH
峬	UIJB
??	UIKK
??	UILE
嵣	UILR
??	UIMI
??	UIMO
鬯	UIP
??	UJBC
岤	UJC
巔	UJCC
崆	UJCM
嵱	UJCR
櫱	UJD
岐	UJE
糱	UJFD
??	UJIG
嶄	UJJL
??	UJKI
峔	UJKP
蠥	UJLMI
崨	UJLO
崇	UJMF
豐	UJMRT
孽	UJND
岮	UJP
岵	UJR
??	UJV
凶	UK
峟	UKB
??	UKCF
峚	UKG
嶽	UKHK
兇	UKHU
輋	UKJJ
崤	UKKB
崦	UKLU
崎	UKMR
峓	UKN
峽	UKOO
嵽	UKPB
??	UKR
屴	UKS
屮	UL
岟	ULBK
岪	ULLN
嶁	ULLV
岫	ULW
峘	UMAM
崸	UMBC
耑	UMBL
嶀	UMBS
炭	UMF
岯	UMFM
崖	UMGG
??	UMGI
??	UMHL
峌	UMIG
??	UMIN
??	UMJJ
蚩	UMLI
??	UMMC
岸	UMMJ
峿	UMMR
??	UMMS
岏	UMMU
??	UMMV
嵿	UMNC
峛	UMNN
岢	UMNR
??	UMOG
??	UMOI
豳	UMOO
岩	UMR
豈	UMRT
岍	UMT
崋	UMTJ
嶡	UMTO
屼	UMU
嶜	UMUA
岈	UMVH
??	UNAO
嶰	UNBQ
??	UNDF
函	UNE
??	UNHAF
岌	UNHE
??	UNHS
??	UNI
嵹	UNII
??	UNIR
??	UNL
??	UNLN
峗	UNMU
嶝	UNOT
嵥	UNQD
??	UNRE
巉	UNRI
??	UNRN
??	UNYO
崔	UOG
巂	UOGB
嶕	UOGF
嶲	UOGS
嶺	UOIC
??	UOII
岑	UOIN
嵢	UOIR
岕	UOLL
崙	UOMB
??	UOMG
崳	UOMN
嶮	UOMO
峇	UOMR
??	UOMV
屹	UON
??	UORM
岝	UOS
??	UOYM
峋	UPA
岉	UPHH
嶷	UPKO
岣	UPR
??	UQKI
崝	UQMB
嶊	UQOG
嶯	URJI
嶉	UROG
??	URRD
巖	URRK
??	URRR
崿	URRS
屺	URU
岷	URVP
??	URYTJ
??	USFI
屻	USHI
岧	USHR
崌	USJR
峮	USKR
嶍	USMA
嵺	USMH
??	USMI
嶇	USRR
岠	USS
屺	USU
崛	USUU
嶱	UTAV
??	UTBC
覬	UTBUU
??	UTCB
嶪	UTCD
??	UTCH
??	UTCNH
崷	UTCW
嶬	UTGI
豔	UTGIT
??	UTGK
??	UTHJ
凱	UTHN
颽	UTHNI
巕	UTHV
獃	UTIK
??	UTJD
剴	UTLN
顗	UTMBC
嵌	UTMO
嵁	UTMV
艷	UTNAU
酆	UTNL
敳	UTOK
嵯	UTQM
巏	UTRG
嵫	UTVI
嶆	UTWA
嶟	UTWI
??	UTWT
嶩	UTWV
出	UU
嵕	UUCE
??	UUHJ
??	UUMJ
祟	UUMMF
??	UUMT
芔	UUU
茻	UUUU
??	UVHG
幽	UVII
岰	UVIS
嶈	UVMI
崰	UVVW
崮	UWJR
岬	UWL
嵎	UWLB
嶧	UWLJ
嶵	UWLY
崽	UWP
崹	UYBB
??	UYBG
巘	UYBK
巃	UYBP
嵃	UYHH
嵼	UYHM
嵃	UYKH
嵼	UYKM
??	UYMY
崒	UYOJ
嵩	UYRB
崞	UYRD
嵉	UYRN
崺	UYSD
??	UYSO
岦	UYT
巇	UYTI
嶂	UYTJ
峐	UYVO
女	V
娼	VAA
媼	VABT
媢	VABU
媚	VAHU
妲	VAM
婸	VAMH
媞	VAMO
??	VANA
嫺	VANB
嫻	VAND
??	VANW
??	VAPV
嫚	VAWE
??	VB
嫇	VBAC
嬡	VBBE
姍	VBBM
媧	VBBR
??	VBCV
婇	VBD
婤	VBGR
??	VBHF
婬	VBHG
??	VBHN
嫍	VBHX
??	VBJJ
姐	VBM
媛	VBME
姛	VBMR
媱	VBOU
??	VBQR
??	VBSD
姍	VBT
娊	VBUU
娞	VBV
妐	VCI
娣	VCNH
妢	VCSH
??	VDAM
妺	VDJ
勦	VDKS
娕	VDL
嬾	VDLC
嫩	VDLK
剿	VDLN
鄛	VDNL
??	VDP
??	VDW
??	VDWF
奴	VE
盝	VEBT
努	VEKS
帑	VELB
剝	VELN
砮	VEMR
弩	VEN
孥	VEND
怒	VEP
拏	VEQ
駑	VESQF
??	VEV
曫	VFA
縕	VFABT
??	VFAIL
緹	VFAMO
緆	VFAPH
緄	VFAPP
繓	VFASE
縵	VFAWE
??	VFB
繃	VFBB
縎	VFBBB
綬	VFBBE
緺	VFBBR
纓	VFBCV
綵	VFBD
綢	VFBGR
縚	VFBHX
緷	VFBJJ
組	VFBM
緩	VFBME
絧	VFBMR
綒	VFBND
縩	VFBOF
綢	VFBQR
絅	VFBR
絼	VFBSH
綱	VFBTU
網	VFBTV
矕	VFBU
緲	VFBUH
繉	VFBUO
綏	VFBV
??	VFBW
鑾	VFC
綈	VFCNH
綌	VFCOR
紛	VFCSH
繒	VFCWA
欒	VFD
緗	VFDBU
綝	VFDD
紂	VFDI
綀	VFDL
絊	VFDM
緯	VFDMQ
??	VFDQ
練	VFDWF
縔	VFEED
綴	VFEEE
婒	VFF
綃	VFFB
??	VFFD
繗	VFFDQ
緂	VFFF
紗	VFFH
絖	VFFMU
絆	VFFQ
綣	VFFQU
綾	VFGCE
絓	VFGG
繞	VFGGU
紶	VFGI
??	VFGNI
??	VFGOW
??	VFGP
結	VFGR
纈	VFGRC
續	VFGWC
妙	VFH
綿	VFHAB
線	VFHAE
鸞	VFHAF
繌	VFHCE
繡	VFHDS
緌	VFHDV
繙	VFHDW
??	VFHEJ
絳	VFHEQ
絡	VFHER
終	VFHEY
紝	VFHG
纁	VFHGF
??	VFHII
??	VFHIR
絑	VFHJD
緞	VFHJE
緟	VFHJG
綞	VFHJM
繑	VFHKB
??	VFHML
??	VFHNI
絎	VFHON
縱	VFHOO
綹	VFHOR
??	VFHPA
綁	VFHQL
紩	VFHQO
編	VFHSB
繳	VFHSK
纘	VFHUC
紙	VFHVP
綼	VFHWJ
總	VFHWP
綹	VFHYR
縛	VFIBI
??	VFIHI
緘	VFIHR
??	VFIHS
線	VFII
縿	VFIIH
絨	VFIJ
絿	VFIJE
紎	VFIK
紱	VFIKK
紌	VFIKU
絒	VFILL
絘	VFIMO
??	VFIP
紿	VFIR
緎	VFIRM
??	VFIRP
??	VFIT
纊	VFITC
纏	VFIWG
縝	VFJBC
綍	VFJBD
??	VFJD
縳	VFJII
繐	VFJIP
??	VFJIV
緒	VFJKA
??	VFJKI
緁	VFJLO
緀	VFJLV
繽	VFJMC
綜	VFJMF
??	VFJMM
紵	VFJMN
綻	VFJMO
綄	VFJMU
綩	VFJNU
縮	VFJOA
紽	VFJP
縖	VFJQR
綰	VFJRR
??	VFJV
縡	VFJYJ
奱	VFK
繚	VFKCF
紘	VFKI
絺	VFKKB
??	VFKM
綺	VFKMR
??	VFKMS
紈	VFKNI
??	VFKPB
??	VFKS
紻	VFLBK
紞	VFLBU
繣	VFLGM
紃	VFLLL
紼	VFLLN
縷	VFLLV
繢	VFLMC
蠻	VFLMI
絩	VFLMO
緋	VFLMY
紬	VFLW
紳	VFLWL
絏	VFLWP
繡	VFLX
紅	VFM
絔	VFMA
??	VFMAM
繻	VFMBB
纋	VFMBE
??	VFMBI
緛	VFMBK
??	VFMCW
紆	VFMD
紑	VFMF
緻	VFMGE
緻	VFMGK
縓	VFMHF
縉	VFMIA
絰	VFMIG
緉	VFMLB
綆	VFMLK
紜	VFMMI
??	VFMMO
纚	VFMMP
糽	VFMN
??	VFMU
縟	VFMVI
經	VFMVM
縹	VFMWF
??	VFMWG
??	VFMWJ
緬	VFMWL
韁	VFMWM
彎	VFN
絕	VFNAU
??	VFNAY
繲	VFNBQ
孿	VFND
紐	VFNG
繘	VFNHB
級	VFNHE
繈	VFNII
紓	VFNIN
繺	VFNKF
綎	VFNKG
綖	VFNKM
紖	VFNL
縃	VFNOB
纔	VFNRI
緮	VFOAE
納	VFOB
臠	VFOBO
??	VFOD
紨	VFODI
維	VFOG
紾	VFOHH
纖	VFOIM
紟	VFOIN
??	VFOIR
變	VFOK
??	VFOLD
紒	VFOLL
繪	VFOMA
綸	VFOMB
絟	VFOMG
緶	VFOMK
緰	VFOMN
給	VFOMR
??	VFOMV
紇	VFON
緱	VFONK
絁	VFOPD
??	VFOQ
??	VFORD
纀	VFOTO
戀	VFP
絢	VFPA
約	VFPI
約	VFPM
緪	VFPMM
綯	VFPOU
紕	VFPP
絇	VFPR
??	VFPRU
紲	VFPT
??	VFPTD
純	VFPU
縐	VFPUU
攣	VFQ
綁	VFQJL
縥	VFQKD
??	VFQKI
綪	VFQMB
績	VFQMC
縤	VFQMF
??	VFQMV
??	VFQN
婘	VFQU
轡	VFR
絹	VFRB
縜	VFRBC
絽	VFRHR
緡	VFRPA
繰	VFRRD
繟	VFRRJ
??	VFRSE
緝	VFRSJ
繩	VFRXU
紉	VFSHI
紹	VFSHR
絕	VFSHU
緅	VFSJE
綅	VFSME
繆	VFSMH
??	VFSP
紀	VFSU
纜	VFSWU
縸	VFTAK
繖	VFTBK
縊	VFTCT
緧	VFTCW
??	VFTGK
繕	VFTGR
緙	VFTLJ
??	VFTLK
紺	VFTM
??	VFTMC
??	VFTQ
縒	VFTQM
??	VFTSJ
絣	VFTT
??	VFTTB
繕	VFTTR
??	VFTW
繜	VFTWI
繷	VFTWV
縑	VFTXC
巒	VFU
??	VFUAP
繃	VFUBB
??	VFUCE
纗	VFUOB
繀	VFUOG
絀	VFUU
孌	VFV
??	VFVDL
??	VFVID
絲	VFVIF
糾	VFVL
綠	VFVNE
緣	VFVNO
繅	VFVVD
繼	VFVVI
緇	VFVVW
細	VFW
綑	VFWD
纆	VFWGG
絪	VFWK
纙	VFWLG
繹	VFWLJ
繯	VFWLV
縕	VFWOT
緦	VFWP
縪	VFWTJ
縲	VFWVF
綽	VFYAJ
締	VFYBB
??	VFYBC
縍	VFYBS
絞	VFYCK
紸	VFYG
繨	VFYGQ
縫	VFYHJ
縋	VFYHR
紡	VFYHS
??	VFYHV
織	VFYIA
繂	VFYIJ
統	VFYIU
紏	VFYJ
縺	VFYJJ
紋	VFYK
繾	VFYLR
綷	VFYOJ
纑	VFYPT
縞	VFYRB
綧	VFYRD
綡	VFYRF
纕	VFYRV
縼	VFYSO
繸	VFYTO
繶	VFYTP
縌	VFYTU
縭	VFYUB
絃	VFYVI
絯	VFYVO
縴	VFYVQ
繵	VFYWM
縗	VFYWV
姌	VGB
??	VGBT
婈	VGCE
焋	VGF
娃	VGG
嬈	VGGU
奘	VGK
嬦	VGNI
嬙	VGOW
??	VGP
姞	VGR
嬯	VGRG
嬉	VGRR
媴	VGRV
婞	VGTJ
??	VGV
裝	VGYHV
婂	VHAB
??	VHAF
媓	VHAG
嬝	VHAV
姠	VHBR
嬼	VHCN
姀	VHD
??	VHDA
娳	VHDN
??	VHDS
婑	VHDV
嬏	VHDW
??	VHE
??	VHFS
妊	VHG
姺	VHGU
媹	VHHW
鄉	VHIIL
??	VHIO
奷	VHJ
姝	VHJD
??	VHJG
娷	VHJM
姡	VHJR
妖	VHK
嬌	VHKB
婖	VHKP
妡	VHML
姤	VHMR
姵	VHNB
??	VHNF
??	VHOM
奼	VHP
婚	VHPA
娥	VHQI
姓	VHQM
??	VHQO
妒	VHS
媥	VHSB
鄉	VHSJL
嬓	VHSK
媿	VHUI
媳	VHUP
??	VHVF
婢	VHWJ
媲	VHWP
嫂	VHXE
??	VHXG
婗	VHXU
⼳	VI
娘	VIAV
嬤	VICI
??	VICY
樂	VID
嬤	VIDI
??	VIDY
漿	VIE
糸	VIF
墏	VIG
幾	VIHI
斷	VIHML
獎	VIIK
??	VIIL
娀	VIJ
獎	VIK
媯	VIKF
幼	VIKS
鴢	VIKSF
嫞	VILB
嫝	VILE
螿	VILMI
劙	VILN
醬	VIMCW
以	VIO
娭	VIOK
始	VIR
幻	VIS
??	VIT
嬚	VITC
嫬	VITF
娏	VIUH
??	VIV
畿	VIW
??	VJBC
婻	VJBJ
嫆	VJCR
妹	VJD
妓	VJE
奼	VJHP
嬸	VJHW
嫥	VJII
??	VJIP
??	VJJV
媎	VJKA
姥	VJKP
婕	VJLO
嬪	VJMC
婃	VJMF
媗	VJMM
嫁	VJMO
??	VJMU
??	VJMW
婉	VJNU
嬣	VJPN
姑	VJR
媩	VJRB
嫴	VJRJ
婠	VJRR
??	VJRU
姲	VJV
姷	VKB
盭	VKBT
嫽	VKCF
??	VKMB
婍	VKMR
姱	VKMS
姨	VKN
嫉	VKOK
凵	VL
姎	VLBK
嫿	VLGM
嚮	VLHBR
丱	VLLLM
蠁	VLLMI
爿	VLM
嬇	VLMC
姚	VLMO
嬧	VLMT
饗	VLOIV
收	VLOK
妯	VLW
妽	VLWL
娉	VLWS
姊	VLXH
??	VLXL
響	VLYTA
妅	VM
姮	VMAM
嬬	VMBB
將	VMBDI
??	VMBE
??	VMBI
嫮	VMBS
孀	VMBU
??	VMBV
彙	VMBWD
床	VMD
??	VMF
嬭	VMFB
彝	VMFFT
??	VMFHK
??	VMFHT
壯	VMG
??	VMGB
娾	VMGG
牆	VMGOW
嫄	VMHF
斨	VMHML
戕	VMI
姪	VMIG
狀	VMIK
奸	VMJ
妍	VMJJ
??	VMJR
??	VMKP
蠿	VMLII
婭	VMLM
妘	VMMI
牁	VMMNR
孋	VMMP
??	VMMR
妧	VMMU
娠	VMMV
??	VMNR
牄	VMOIR
??	VMPM
彘	VMPOP
妒	VMR
妍	VMT
牂	VMTQ
妝	VMV
媷	VMVI
娙	VMVM
嫖	VMWF
??	VMWK
媔	VMWL
??	VMWV
嫣	VMYF
姃	VMYM
娩	VNAU
??	VNBK
好	VND
妳	VNF
妞	VNG
媃	VNHD
奶	VNHS
妤	VNIN
姳	VNIR
娗	VNKG
??	VNKM
??	VNL
嫷	VNLB
婀	VNLR
彔	VNME
嫋	VNMM
彖	VNMO
姽	VNMU
婿	VNOB
嬁	VNOT
??	VNST
嬔	VNUM
娹	VNYI
??	VNYO
妠	VOB
孇	VOGE
嫶	VOGF
鶨	VOHAF
妊	VOHG
姈	VOII
孅	VOIM
妗	VOIN
??	VOIR
蠡	VOLII
妎	VOLL
??	VOMB
??	VOMC
姾	VOMG
媮	VOMN
嬐	VOMO
姶	VOMR
媮	VOMV
姩	VOQ
媬	VORD
媕	VORT
嫵	VOTF
??	VOWY
她	VPD
??	VPFD
妼	VPH
妁	VPI
??	VPM
妣	VPP
??	VPPA
姁	VPR
媟	VPTD
媰	VPUU
妦	VQJ
媋	VQKA
嫀	VQKD
婧	VQMB
嫊	VQMF
婊	VQMV
如	VR
娟	VRB
??	VRC
鴽	VRHAF
??	VRHQM
帤	VRLB
恕	VRP
挐	VRQ
嬠	VRRD
嬋	VRRJ
孍	VRRK
婽	VRSE
??	VRSQF
絮	VRVIF
娛	VRVK
??	VRVP
娖	VRYO
孎	VSEI
鶭	VSHAF
妱	VSHR
娓	VSHU
娵	VSJE
??	VSJR
嫕	VSKP
姬	VSLL
婦	VSMB
嬥	VSMG
嫪	VSMH
??	VSMM
??	VSND
??	VSO
妮	VSP
媽	VSQF
娜	VSQL
??	VSRP
嫗	VSRR
姖	VSS
嫟	VSTR
??	VSTT
妃	VSU
嫫	VTAK
??	VTAW
婰	VTBC
媊	VTBN
??	VTC
??	VTCW
媄	VTGK
??	VTGP
嫸	VTGR
嬞	VTHG
婼	VTKR
嫹	VTLC
嬿	VTLF
??	VTLG
??	VTLK
??	VTLM
嫨	VTLO
姏	VTM
娸	VTMC
媒	VTMD
??	VTMH
嬅	VTMJ
??	VTOP
??	VTRG
媶	VTSJ
姘	VTT
媾	VTTB
嫸	VTTR
??	VTUI
??	VTVI
嬨	VTVP
媌	VTW
嫌	VTXC
??	VTYX
奾	VU
??	VUF
??	VUGK
媏	VUMB
媸	VUMI
婩	VUMJ
孈	VUOB
雝	VUOG
媺	VUUK
奻	VV
災	VVF
??	VVFB
姒	VVIO
??	VVNO
邕	VVRAU
姦	VVV
甾	VVW
巢	VVWD
媦	VWB
婐	VWD
娌	VWG
??	VWGV
鶅	VWHAF
疀	VWJLO
婟	VWJR
姻	VWK
??	VWLJ
嬽	VWLK
嬛	VWLV
媼	VWOT
??	VWSV
嫘	VWVF
姆	VWYI
婥	VYAJ
媜	VYBC
嫡	VYCB
姣	VYCK
??	VYDK
婌	VYFE
妵	VYG
??	VYHN
妨	VYHS
嬂	VYIA
妏	VYK
??	VYLB
娮	VYMR
??	VYOJ
嫭	VYPD
??	VYPN
??	VYPU
??	VYRB
婛	VYRF
婷	VYRN
??	VYRU
孃	VYRV
嫙	VYSO
??	VYT
??	VYTD
嫜	VYTJ
??	VYTO
??	VYTP
婄	VYTR
妶	VYVI
嬗	VYWM
田	W
胃	WB
顒	WBMBC
愚	WBP
四	WC
囧	WCB
鷶	WCHAF
畟	WCHE
??	WCK
??	WCYS
果	WD
??	WDH
褁	WDHV
顆	WDMBC
圍	WDMQ
夥	WDNIN
敤	WDYE
畷	WEEE
疄	WFDQ
黠	WFGR
黷	WFGWC
黲	WFIIH
默	WFIK
黓	WFIP
黰	WFJBC
黦	WFJNU
黤	WFKLU
黕	WFLBU
黖	WFMVU
黫	WFMWG
黵	WFNCR
黟	WFNIN
黔	WFOIN
黭	WFORT
畔	WFQ
圈	WFQU
黚	WFTM
黮	WFTMV
黜	WFUU
黝	WFVIS
點	WFYR
黥	WFYRF
黯	WFYTA
里	WG
??	WGB
??	WGCG
畤	WGDI
黑	WGF
??	WGFBT
墨	WGFG
畦	WGG
??	WGGG
圔	WGIT
疇	WGNI
野	WGNIN
園	WGRV
圉	WGTJ
囷	WHD
畈	WHE
略	WHER
畽	WHJG
畯	WICE
鸀	WIHAF
圃	WIJB
畎	WIK
歜	WINO
??	WIR
國	WIRM
斀	WIYE
毌	WJ
貫	WJBUC
??	WJCN
??	WJD
毋	WJH
鸅	WJHAF
團	WJII
??	WJNO
畹	WJNU
斁	WJOK
固	WJR
因	WK
囿	WKB
??	WKBT
??	WKM
畸	WKMR
欭	WKNO
恩	WKP
男	WKS
甲	WL
??	WLB
禺	WLBI
罝	WLBM
罦	WLBND
買	WLBUC
??	WLCNH
罾	WLCWA
罧	WLDD
??	WLDLO
罬	WLEEE
??	WLGA
罣	WLGG
??	WLGGI
罫	WLGGY
瞏	WLGRV
睪	WLGTJ
鴨	WLHAF
罶	WLHHW
罛	WLHVO
??	WLIAV
??	WLIB
罷	WLIBP
??	WLIHI
??	WLIHS
羆	WLIPF
罭	WLIRM
??	WLIXP
置	WLJBM
署	WLJKA
罟	WLJR
罨	WLKLU
目	WLL
甽	WLLL
罪	WLLMY
圚	WLMC
罘	WLMF
罽	WLMFN
??	WLMHM
??	WLMJ
睘	WLMRV
罡	WLMYM
??	WLNDO
罞	WLNIH
眾	WLOOO
蜀	WLPLI
罹	WLPOG
??	WLQKA
罥	WLRB
罠	WLRVP
罻	WLSFI
罵	WLSQF
羃	WLTAB
羈	WLTJF
羇	WLTJR
羉	WLVFF
羅	WLVFG
??	WLVIF
罺	WLVVD
??	WLW
??	WLWJR
罳	WLWP
罼	WLWTJ
奰	WLWWK
罩	WLYAJ
??	WLYBG
罜	WLYG
詈	WLYMR
罰	WLYRI
罰	WLYRN
??	WLYRY
罿	WLYTG
畀	WML
圄	WMMR
??	WMMV
町	WMN
圂	WMSO
畏	WMV
??	WMYM
囝	WND
墅	WNG
囚	WO
畛	WOHH
囹	WOII
畋	WOK
界	WOLL
圇	WOMB
??	WOMC
慁	WOP
??	WOWY
思	WP
??	WPD
囫	WPHH
??	WPIM
腮	WPMBC
畇	WPMM
毗	WPP
囤	WPU
圊	WQMB
回	WR
圓	WRBC
圖	WRJW
??	WRSE
圖	WRYW
嬲	WSVWS
??	WT
異	WTC
畢	WTJ
??	WTT
圌	WUMB
囡	WV
圞	WVFD
??	WVFF
累	WVIF
翾	WVSMM
??	WW
鸓	WWHAF
圛	WWLJ
圜	WWLV
畾	WWW
櫐	WWWD
纍	WWWF
壘	WWWG
??	WWWK
疊	WWWM
礨	WWWR
罍	WWWU
壨	WWWWG
囥	WYHN
母	WYI
圁	WYMR
??	WYND
??	WYTG
甿	WYV
??	WYVO
曰	XA
昍	XAA
暈	XABJJ
炚	XAF
顥	XAFMB
??	XAFMU
晑	XAHBR
??	XAIHS
??	XAITC
??	XAJ
??	XAJKA
??	XAMBI
旰	XAMJ
??	XAMOB
冕	XANAU
??	XANBU
??	XANL
欥	XANO
昒	XAPHH
煦	XARF
??	XASF
??	XATC
旵	XAU
??	XAUKS
昢	XAUU
鷃	XAVHA
旼	XAYK
晾	XAYRF
??	XAYVI
??	XBB
??	XBBB
郥	XBCNL
??	XBDI
縢	XBFQF
冗	XBHN
膬	XBHUU
??	XBHWP
??	XBKF
鶪	XBKHA
??	XBLLN
肛	XBM
??	XBMBC
刞	XBMLN
??	XBMRW
塚	XBMSO
脕	XBNAU
冊	XBT
覞	XBUBU
瞗	XBUHA
??	XBUHQ
瞚	XBUJM
睢	XBUOG
臅	XBWLI
??	XCDHE
??	XCF
??	XCFBC
銩	XCHGI
鳻	XCHHA
釽	XCHLO
??	XCHNE
釩	XCHNI
鎞	XCHWP
??	XCI
銊	XCIHM
??	XCIHQ
釴	XCIP
鐮	XCITC
鏔	XCJMC
鎵	XCJMO
釱	XCK
鈦	XCKI
釚	XCKN
??	XCL
??	XCMBC
銔	XCMFJ
??	XCMLB
銫	XCNAU
??	XCNIN
弚	XCNL
鐊	XCNLH
??	XCNO
鋡	XCOIR
鉓	XCOLB
錀	XCOMB
??	XCOP
鈊	XCP
??	XCPA
鉤	XCPI
??	XCSHI
弅	XCSHT
鑆	XCTGI
??	XCTGT
??	XCTOR
鐹	XCYBB
??	XCYCK
銃	XCYIU
??	XCYPQ
??	XCYRN
鋅	XCYTJ
??	XDA
柦	XDAM
??	XDANR
棗	XDBDB
??	XDBY
??	XDDD
??	XDDG
檒	XDDHN
??	XDDK
??	XDDP
榃	XDDW
??	XDF
??	XDG
板	XDHE
??	XDHJU
杋	XDHNI
椼	XDHON
橁	XDHPA
??	XDHUJ
??	XDI
??	XDIK
櫠	XDINE
??	XDIP
??	XDJBM
??	XDJMO
杕	XDK
朹	XDKN
??	XDKP
檶	XDKSR
柫	XDLLN
??	XDLMO
杠	XDM
??	XDMCW
??	XDMFM
??	XDMMS
枑	XDMVM
槱	XDMWF
杍	XDND
楺	XDNHD
杼	XDNIN
梒	XDOIR
杺	XDP
栺	XDPA
构	XDPI
??	XDRRR
框	XDSMG
??	XDSP
??	XDTJR
??	XDTM
??	XDTMJ
??	XDTW
??	XDU
??	XDVVW
梱	XDWD
檛	XDYBB
梓	XDYTJ
檤	XDYTU
榱	XDYWV
沓	XEA
灝	XEAFC
??	XEANB
闊	XEANR
滘	XEBCR
??	XEBP
濉	XEBUG
??	XEBUU
汃	XEC
??	XEDBT
沝	XEE
??	XEEE
??	XEEED
??	XEFFF
??	XEG
瀔	XEGDE
塣	XEGG
盪	XEHBT
灚	XEHBU
??	XEHMO
硰	XEHMR
渢	XEHNI
漇	XEHOO
淚	XEHSK
瀩	XEHUC
??	XEID
??	XEIHR
??	XEIK
濂	XEITC
漥	XEJCG
??	XEJCK
浨	XEJD
濣	XEJJJ
演	XEJMC
??	XEK
汯	XEKI
浠	XEKKB
氿	XEKN
灗	XELIM
沜	XELLL
??	XELMC
灞	XEMBB
澪	XEMBI
灑	XEMCW
鴻	XEMHF
??	XEMR
沍	XEMVM
??	XEMWF
湹	XEMWG
泓	XENI
沀	XENIN
??	XENST
??	XEO
瀹	XEOMB
渝	XEOMN
涻	XEOMR
??	XEORT
??	XEP
柒	XEPD
??	XESMC
洭	XESMG
??	XESMJ
??	XETLO
汫	XETT
渵	XETW
鍌	XEUC
??	XEW
涃	XEWD
濄	XEYBB
??	XEYCK
??	XEYHC
??	XEYLC
??	XEYPU
??	XEYRO
湤	XEYSD
滖	XEYWV
??	XFBBE
敞	XFBOK
炯	XFBR
炑	XFD
??	XFDW
??	XFDWD
??	XFE
??	XFF
熒	XFFBF
??	XFFC
??	XFFF
爃	XFFFD
顃	XFFMB
??	XFFNO
??	XFKKB
??	XFMU
??	XFOG
焓	XFOIR
熤	XFSMT
烡	XFTC
??	XFTWB
??	XFTWI
熵	XFYCB
??	XFYRD
??	XFYTJ
榖	XGDHN
愨	XGEP
鷇	XGFHN
??	XGG
??	XGGG
墝	XGGGU
??	XGHWJ
??	XGI
??	XGIF
劫	XGIKS
??	XGINL
摰	XGIQ
螫	XGKLM
堧	XGMBB
彀	XGNHN
??	XGNO
??	XGOO
堩	XGPMM
??	XGRGR
欯	XGRNO
嘉	XGRTR
??	XGSEQ
??	XGSJT
??	XGTOR
??	XGU
??	XGUCE
??	XGYCB
垶	XGYTJ
丿	XH
馫	XHAHA
癿	XHAU
??	XHBDD
爂	XHBF
鷮	XHBHA
??	XHBHG
顅	XHBMB
礐	XHBMR
嶨	XHBU
篹	XHBUU
劗	XHCLN
鄮	XHCNL
鷍	XHDHA
??	XHDI
種	XHDL
剁	XHDLN
秞	XHDLW
??	XHDMR
鄡	XHDNL
夊	XHE
??	XHED
釆	XHFD
??	XHFN
簃	XHHDN
??	XHHHA
簁	XHHOO
??	XHHP
篦	XHHWP
??	XHJD
簙	XHJII
??	XHJNL
??	XHJSM
??	XHKA
鸄	XHKHA
懲	XHKP
啟	XHKR
嶴	XHKU
笰	XHLLN
籈	XHMGN
鷎	XHMHA
邸	XHMNL
??	XHMR
梨	XHND
??	XHNHA
??	XHNP
彳	XHO
??	XHOB
鴩	XHOHA
??	XHOHQ
??	XHOIR
??	XHOP
瓝	XHOPI
??	XHOPR
黴	XHOUF
筍	XHPA
??	XHPP
鴰	XHRHA
劄	XHRLN
郈	XHRNL
勹	XHS
籊	XHSMG
笸	XHSR
??	XHTCE
??	XHUF
鶞	XHUHA
兟	XHUHG
郋	XHUNL
憩	XHUP
覣	XHVBU
鶹	XHWHA
??	XHYOI
箎	XHYPU
笘	XHYR
丶	XI
宀	XIB
鷛	XIBHA
鄘	XIBNL
??	XID
鄬	XIFNL
??	XIFOM
慼	XIFP
??	XIFWD
蠯	XIHJI
剆	XIILN
庋	XIJE
義	XIK
亠	XIM
栥	XIOD
庀	XIP
??	XIPBU
麃	XIPF
鳶	XIPHA
庇	XIPP
怠	XIRP
弁	XIT
??	XJAF
??	XJBVI
鷏	XJCHA
??	XJCMB
穵	XJCN
??	XJCNL
宋	XJD
??	XJEC
??	XJIHA
廾	XJJ
??	XJJAB
??	XJJMJ
??	XJJOM
??	XJJOS
轛	XJJTG
??	XJJU
軿	XJJYJ
??	XJMUE
鶷	XJRHA
宧	XJSLL
鶱	XJTCF
剋	XJULN
鴳	XJVHA
寱	XJVMD
寣	XJVMR
乂	XK
冇	XKB
郁	XKBNL
瘌	XKDLN
疢	XKF
猏	XKHHS
癓	XKHOK
痻	XKHPA
痲	XKJCC
瘏	XKJKA
痏	XKKB
鸑	XKKHA
疘	XKM
??	XKMMS
痾	XKMNR
夷	XKN
旮	XKNA
厹	XKNI
痑	XKNIN
鴐	XKRHA
羍	XKTQ
尢	XKU
??	XL
幊	XLBMB
蚓	XLIJM
??	XLIOI
蝆	XLITQ
??	XLIUO
??	XLIYK
衶	XLL
冖	XLN
冑	XLWB
裍	XLWD
鸍	XMBHA
貢	XMBUC
??	XMBYT
??	XMDDA
覝	XMFBU
顠	XMFMB
玥	XMGB
??	XMGD
??	XMGFF
鳿	XMGHA
??	XMGHX
玊	XMGI
臹	XMGIH
??	XMGKL
??	XMGMB
??	XMGMV
鄄	XMGNL
歅	XMGNO
琀	XMGOI
玫	XMGOK
珌	XMGPH
玭	XMGPP
臻	XMGQK
??	XMGTC
??	XMGTO
珫	XMGYI
??	XMGYP
??	XMINL
鷣	XMJHA
??	XMKE
憨	XMKP
鵛	XMMHA
??	XMMLN
??	XMMMB
??	XMNF
鴷	XMNHA
殥	XMNJM
恐	XMNP
剢	XMOLN
泵	XMRE
??	XMRG
??	XMRHQ
??	XMRJM
酃	XMRNL
歌	XMRNO
敔	XMROK
礣	XMRTW
??	XMTLN
郖	XMTNL
??	XMV
??	XMVB
堙	XMWG
亅	XN
弝	XNAU
墮	XNBG
觔	XNBKS
氶	XNE
??	XNEMS
??	XNFMM
??	XNFOI
??	XNFOM
??	XNFPI
鱴	XNFTW
弘	XNI
弔	XNL
??	XNLFH
陝	XNLKO
??	XNLYK
檃	XNMD
久	XNO
墬	XNOG
??	XNPD
??	XNSF
仴	XOB
烋	XODF
??	XODP
汆	XOE
尒	XOF
??	XOFD
鷡	XOFHA
隹	XOG
栠	XOGD
隻	XOGE
鵀	XOGHA
犨	XOGHQ
恁	XOGP
佶	XOGR
俍	XOIAV
侂	XOIHP
??	XOIKK
怤	XOIP
午	XOJ
??	XOJBC
鴙	XOKHA
侇	XOKN
??	XOKP
佑	XOKR
??	XOL
絛	XOLOF
倏	XOLOK
仝	XOM
??	XOMBP
??	XOMD
嵞	XOMDU
??	XOMMP
侲	XOMMV
气	XOMN
??	XOMNN
??	XOMR
伃	XONIN
伄	XONL
??	XOO
??	XOOF
倠	XOOG
伈	XOP
貸	XOPBU
柋	XOPD
??	XOPFD
伅	XOPU
??	XORBT
鶬	XORHA
??	XORHU
頷	XORMB
??	XORMW
??	XORSM
??	XOSMG
僛	XOTCO
仚	XOU
??	XOUOB
??	XOUYP
僆	XOYJJ
偯	XOYRV
旨	XPA
熲	XPFMB
??	XPFQU
曶	XPHA
??	XPHBK
??	XPHP
悷	XPHSK
勺	XPI
??	XPK
??	XPKF
勼	XPKN
愩	XPMBC
匉	XPMFJ
愊	XPMRW
憟	XPMWD
恉	XPPA
忉	XPSH
忷	XPUK
村	XPUNL
慛	XPUOG
悃	XPWD
??	XPYV
洯	XQHE
扷	XQHK
抓	XQHLO
恝	XQHP
揙	XQHSB
捩	XQHSK
??	XQHWJ
搣	XQIHF
??	XQJCN
鄻	XQJNL
焎	XQLF
??	XQMGN
??	XQNAU
拸	XQNIN
??	XQNO
捨	XQOMR
??	XQORQ
??	XQPI
擢	XQSMG
摒	XQSYJ
??	XQTW
捰	XQWD
撾	XQYBB
摙	XQYJJ
??	XRANR
邑	XRAU
唄	XRBUC
叭	XRC
劋	XRDLN
??	XRHBT
唳	XRHSK
嚓	XRJBF
戢	XRJI
呔	XRKI
叻	XRKS
唒	XRMCW
啀	XRMGG
蹝	XRMHO
??	XRMMP
唔	XRMMR
唅	XROIR
啥	XROMR
咰	XRPA
獸	XRRIK
喿	XRRRD
鴞	XRSHA
咡	XRSJ
喔	XRSMG
??	XRTGI
??	XRTK
囆	XRTWI
喍	XRYPD
臀	XSEB
贀	XSEBU
壂	XSEG
嫛	XSEV
繄	XSEVI
騂	XSFYT
鳭	XSHHA
戮	XSHI
屧	XSHOD
屐	XSHOE
慰	XSIP
??	XSJCM
憵	XSJP
屝	XSLMY
??	XSMIG
翋	XSMYT
??	XSRDI
鶋	XSRHA
邵	XSRNL
??	XSRP
群	XSRTQ
已	XSU
??	XSUP
妀	XSUV
槊	XTBD
??	XTBHF
蒯	XTBLN
顢	XTBMB
??	XTBOK
菳	XTC
??	XTCB
鷬	XTCHA
歉	XTCNO
惎	XTCP
莌	XTCRU
鷋	XTDHA
萿	XTEHR
藫	XTEMJ
??	XTEYM
??	XTGF
蓺	XTGGI
羑	XTGNO
戁	XTGP
蘤	XTHAF
??	XTHDB
菞	XTHDH
藒	XTHDV
??	XTHHL
??	XTHNE
藢	XTHOK
蘅	XTHON
蓗	XTHOO
菺	XTHSB
蓖	XTHWP
蒧	XTIHR
??	XTIIL
芅	XTIP
??	XTIPD
??	XTIYL
萓	XTJBM
苧	XTJMN
莞	XTJMU
鄿	XTJNL
??	XTJPI
鞙	XTJRB
鴱	XTKHA
艽	XTKN
鄚	XTKNL
鷰	XTLPF
蕶	XTMBI
莤	XTMCW
芋	XTMD
??	XTMGI
薽	XTMGN
菫	XTMLM
鄞	XTMNL
薞	XTMNV
蓩	XTNHS
茤	XTNIN
茠	XTOD
茌	XTOG
??	XTOIR
蘥	XTOMB
芞	XTOMN
荅	XTOMR
莝	XTOOG
芶	XTPI
羋	XTQ
鄀	XTRNL
??	XTRRS
藯	XTSIP
??	XTSLL
苨	XTSP
并	XTT
蘳	XTTCG
??	XTTGF
??	XTTGI
鵧	XTTHA
荊	XTTLN
艵	XTTNA
刱	XTTSH
??	XTUNE
??	XTVFF
??	XTVFH
??	XTVFU
孳	XTVID
??	XTVIF
??	XTVII
薅	XTVMI
??	XTVMW
曲	XTW
茵	XTWK
薎	XTWLI
甍	XTWLN
藣	XTWLP
薖	XTYBB
??	XTYCV
??	XTYDL
藗	XTYDO
蕸	XTYRE
藹	XTYRV
蒟	XTYTR
??	XUAPP
剻	XUBLN
??	XUBMB
??	XUBMR
??	XUC
峰	XUHEJ
峈	XUHER
??	XUHXC
峸	XUIHS
峖	XUJV
嶚	XUKCF
峏	XUMBL
??	XUMMU
??	XUMNN
??	XUMTO
岋	XUNHE
峞	XUNMU
雟	XUOGB
??	XUOGF
岭	XUOII
岒	XUOIN
??	XUOMB
峆	XUOMR
??	XUOS
??	XURRK
??	XUSHR
艸	XUU
??	XUYBP
峷	XUYTJ
??	XVEND
嫦	XVFBB
??	XVFD
鷥	XVFHA
縰	XVFHO
綟	XVFHS
紁	XVFIK
縯	XVFJM
??	XVFLM
??	XVFMW
絻	XVFNA
您	XVFP
姅	XVFQ
??	XVFU
??	XVFYS
厶	XVI
槳	XVID
婝	XVJMO
??	XVNF
姼	XVNIN
??	XVNL
??	XVOMR
??	XVSU
巛	XVVV
困	XWD
??	XWJ
鷝	XWJHA
囮	XWOP
毘	XWPP
??	XXANO
鷐	XXAVH
囗	XXBM
??	XXBUH
膗	XXBUO
??	XXCJM
??	XXDDG
??	XXDDK
??	XXDF
??	XXDSM
汩	XXEA
??	XXEAN
懘	XXEBP
??	XXEEE
??	XXEG
瀜	XXEMB
??	XXEO
渥	XXESM
??	XXEUC
??	XXFFF
??	XXGDH
??	XXGEP
??	XXGGG
??	XXGIQ
皞	XXHAH
鷽	XXHBH
??	XXHDN
??	XXHE
??	XXHHP
笻	XXHMN
鰴	XXHOU
鵅	XXHRH
??	XXHUF
鵚	XXHUH
??	XXHUP
??	XXID
??	XXIPF
忒	XXIPP
郩	XXKBN
??	XXMBH
??	XXMGO
??	XXNL
??	XXODP
??	XXOF
鯈	XXOLO
亼	XXOM
鵨	XXORH
屳	XXOU
顈	XXPFM
??	XXQJC
唫	XXRC
婜	XXSEV
𥪡	XXSMY
鵘	XXSRH
??	XXTCP
莰	XXTGN
蓏	XXTHO
卌	XXTT
藅	XXTWL
蔎	XXTYR
屾	XXUU
??	XXXES
鵳	XXXHB
鴭	XXXHR
??	XXXHU
麀	XXXIP
鴯	XXXMB
仜	XXXOM
??	XXXTA
??	XXXTB
蓗	XXXTC
蘮	XXXTW
岀	XXXUU
〇	XXXXX
鸆	XXXYA
??	XXXYK
??	XXYCP
褒	XXYHD
顪	XXYHM
鳼	XXYKH
??	XXYRB
??	XXYRN
??	XXYRT
甗	XYBMV
欳	XYBNO
迥	XYBR
鶐	XYCHA
奕	XYCK
戇	XYCP
敹	XYDOK
??	XYEG
褒	XYHDV
顏	XYHMB
??	XYJ
??	XYJMB
鷟	XYKHA
??	XYKI
憝	XYKP
??	XYM
皻	XYMDH
逜	XYMMR
忐	XYMP
劇	XYOLN
迆	XYPD
鸗	XYPHA
龒	XYPMM
礱	XYPMR
讋	XYPYM
詗	XYRBR
毫	XYRBU
??	XYRNL
??	XYROI
??	XYROM
詣	XYRPA
囈	XYRTG
乩	XYRU
??	XYRWB
謪	XYRYC
??	XYRYE
謯	XYRYP
??	XYSG
鴗	XYTHA
??	XYTKR
膂	XYVB
??	XYVGN
邋	XYVVV
??	XYWLG
褱	XYWLV
齋	XYXF
卜	Y
??	YABU
桌	YAD
韹	YAHAG
韸	YAHEJ
??	YAHM
??	YAHQI
戠	YAI
卓	YAJ
逿	YAMH
??	YAMM
??	YAMO
歆	YANO
暹	YAOG
??	YAP
??	YAPH
??	YAPIM
??	YAPMM
遏	YAPV
??	YAQOA
韻	YARBC
韶	YASHR
遢	YASM
韺	YATLK
頀	YATOE
退	YAV
??	YAYBC
??	YAYHJ
髜	YBAHT
過	YBBR
??	YBBU
週	YBGR
鶙	YBHAF
望	YBHG
毃	YBHNE
??	YBHT
邈	YBHU
??	YBHWJ
??	YBI
獻	YBIK
運	YBJJ
帝	YBLB
睿	YBMCU
遯	YBMO
迵	YBMR
甋	YBMVN
鄗	YBNL
歊	YBNO
離	YBOG
敵	YBOK
遙	YBOU
週	YBQR
啻	YBR
??	YBTT
貞	YBUC
敲	YBYE
??	YBYHN
旁	YBYHS
龍	YBYSP
六	YC
商	YCBR
??	YCD
??	YCE
??	YCHAF
??	YCHV
顰	YCHWJ
??	YCIHV
交	YCK
帟	YCLB
??	YCOLI
戇	YCP
兗	YCRHU
袞	YCRHV
??	YCRU
弈	YCT
巒	YCU
??	YCV
親	YDBUU
鶉	YDHAF
虨	YDHHH
新	YDHML
孰	YDKNI
速	YDL
遫	YDLK
違	YDMQ
郭	YDNL
歑	YDNO
雜	YDOG
敦	YDOK
嚲	YDRRJ
攴	YE
督	YEBU
錖	YEC
粲	YEFD
逤	YEFH
壑	YEG
韰	YELSM
餐	YEOIV
惄	YEP
裻	YEYHV
逍	YFB
迷	YFD
遴	YFDQ
叔	YFE
鶁	YFHAF
就	YFIKU
勍	YFKS
??	YFLN
敊	YFYE
主	YG
逵	YGCG
??	YGG
遶	YGGU
殶	YGHNE
氃	YGHQU
褻	YGIV
??	YGKS
虧	YGMMS
迼	YGR
遠	YGRV
遨	YGSK
達	YGTQ
广	YH
迫	YHA
鳪	YHAF
遑	YHAG
亹	YHBM
透	YHDS
逶	YHDV
返	YHE
逢	YHEJ
逄	YHEQ
??	YHG
造	YHGR
彥	YHHHH
產	YHHQM
??	YHHV
遛	YHHW
褢	YHIV
适	YHJR
遁	YHJU
劌	YHLN
頻	YHMBC
近	YHML
遾	YHMO
逅	YHMR
??	YHMY
亢	YHN
??	YHOV
迭	YHQO
造	YHQR
追	YHRR
方	YHS
遍	YHSB
邀	YHSK
翽	YHSMM
邊	YHUS
衣	YHV
迎	YHVL
邍	YHWE
廉	YHXC
??	YHXE
裒	YHXV
??	YHYE
遞	YHYU
育	YIB
逡	YICE
述	YID
熟	YIF
玅	YIFH
塾	YIG
充	YIHU
斔	YIHXO
逋	YIJB
述	YIJC
逑	YIJE
迖	YIK
??	YINE
玈	YIOHV
率	YIOJ
迨	YIR
袬	YIRV
??	YIT
棄	YITD
遮	YITF
玆	YIYVI
斗	YJ
邃	YJCO
辣	YJDL
鵫	YJHAF
贛	YJHEC
彰	YJHHH
瓣	YJHOJ
竷	YJHQE
辨	YJILJ
辦	YJKSJ
??	YJLII
??	YJMBC
??	YJMF
??	YJMO
鄣	YJNL
??	YJNMM
逭	YJRR
??	YJSHR
辮	YJVFJ
連	YJWJ
并	YJYJ
瓶	YJYJN
辯	YJYRJ
文	YK
斕	YKANW
迶	YKB
??	YKC
遼	YKCF
??	YKF
??	YKGG
鵁	YKHAF
斖	YKHBM
逖	YKHF
逛	YKHG
彣	YKHHH
斒	YKHSB
??	YKI
效	YKKS
蠃	YKLMI
??	YKLW
??	YKMB
頝	YKMBC
??	YKMBL
彥	YKMHH
產	YKMHM
斌	YKMPM
??	YKND
郊	YKNL
??	YKNWF
效	YKOK
忞	YKP
遰	YKPB
撉	YKQ
吝	YKR
迦	YKSR
紊	YKVIF
齾	YKYMU
??	YL
市	YLB
逮	YLE
衷	YLHV
??	YLL
止	YLM
遺	YLMC
步	YLMH
逃	YLMO
遣	YLMR
亦	YLNC
迪	YLW
??	YLWL
上	YM
肯	YMB
??	YMBG
贇	YMBUC
覷	YMBUU
??	YMC
迺	YMCW
迂	YMD
皽	YMDHE
邇	YMFB
迋	YMG
歭	YMGDI
鸇	YMHAF
??	YMHF
??	YMHJG
氈	YMHQU
??	YMHV
歲	YMIHH
歧	YMJE
??	YMJR
迗	YMK
勯	YMKS
剷	YMLN
顫	YMMBC
邐	YMMP
言	YMMR
??	YMMU
迾	YMNN
歔	YMNO
??	YMO
??	YMOB
此	YMP
雌	YMPOG
逗	YMRT
逼	YMRW
逐	YMSO
齒	YMUOO
迓	YMVH
逕	YMVM
??	YMWG
??	YMWL
遷	YMWU
??	YMWY
卡	YMY
逸	YNAI
邂	YNBQ
贏	YNBUC
遜	YNDF
鸁	YNHAF
遹	YNHB
袤	YNHV
通	YNIB
迻	YNIN
袲	YNIV
??	YNIY
迅	YNJ
??	YNKNI
蠃	YNLMI
頏	YNMBC
邟	YNNL
邆	YNOT
??	YNQD
??	YNSQF
羸	YNTQ
嬴	YNV
臝	YNWD
??	YO
??	YODI
褒	YODV
進	YOG
毅	YOHNE
??	YOHQM
??	YOIN
迕	YOJ
劾	YOKS
刻	YOLN
頦	YOMBC
途	YOMD
逾	YOMN
逾	YOMV
迄	YON
夜	YONK
欬	YONO
卒	YOOJ
迤	YOPD
??	YORQ
迮	YOS
??	YOV
虍	YP
迿	YPA
眥	YPBU
貲	YPBUC
鈭	YPC
柴	YPD
壟	YPG
??	YPHA
鷾	YPHAF
處	YPHEN
虖	YPHFD
虎	YPHN
虎	YPHU
??	YPHXV
勴	YPKS
??	YPLB
蠪	YPLMI
??	YPM
龑	YPMK
些	YPMM
祡	YPMMF
砦	YPMR
鬳	YPMRB
豦	YPMSO
觜	YPNBG
鮆	YPNWF
胔	YPOBO
飺	YPOIV
虔	YPOK
虙	YPPH
呰	YPR
虞	YPRVK
聾	YPSJ
虐	YPSM
迣	YPT
龔	YPTC
虛	YPTM
虡	YPTMC
迍	YPU
袌	YPUV
紫	YPVIF
膚	YPWB
盧	YPWBT
虜	YPWKS
歶	YPWLB
慮	YPWP
龘	YPYBP
襲	YPYHV
虔	YPYK
訾	YPYMR
逝	YQHL
??	YQJ
??	YQKQ
??	YQMV
占	YR
??	YRAA
??	YRAFU
??	YRAHM
??	YRAM
??	YRAMI
諟	YRAMO
譋	YRANB
讕	YRANW
??	YRANX
??	YRAPH
謁	YRAPV
裛	YRAV
謾	YRAWE
膏	YRBB
??	YRBD
??	YRBF
調	YRBGR
??	YRBHF
諂	YRBHX
諢	YRBJJ
詛	YRBM
諼	YRBME
詷	YRBMR
亭	YRBN
豪	YRBO
謠	YRBOU
亳	YRBP
調	YRBQR
高	YRBR
諍	YRBSD
亮	YRBU
覘	YRBUU
謑	YRBVK
訟	YRCI
諡	YRCMT
說	YRCRU
諃	YRDD
詖	YRDHE
討	YRDI
訣	YRDK
諱	YRDMQ
誺	YRDOO
諫	YRDWF
誻	YREA
京	YRF
誚	YRFB
讜	YRFBF
??	YRFBG
??	YRFBW
??	YRFD
談	YRFF
??	YRFFD
訬	YRFH
詊	YRFQ
讟	YRGCR
詩	YRGDI
詿	YRGG
譊	YRGGU
譸	YRGNI
誌	YRGP
詰	YRGR
譆	YRGRR
讀	YRGWC
??	YRHAE
諻	YRHAG
謻	YRHDN
誘	YRHDS
諉	YRHDV
譒	YRHDW
詻	YRHER
逞	YRHG
譭	YRHGE
誥	YRHGR
詵	YRHGU
??	YRHGY
謝	YRHHI
誅	YRHJD
??	YRHJG
諈	YRHJM
話	YRHJR
訞	YRHK
譑	YRHKB
??	YRHME
訢	YRHML
詬	YRHMR
訴	YRHMY
設	YRHNE
諷	YRHNI
譗	YRHOR
託	YRHP
諙	YRHPA
詆	YRHPM
??	YRHQI
詄	YRHQO
??	YRHQR
諞	YRHSB
??	YRHSK
謆	YRHSM
讚	YRHUC
哀	YRHV
諀	YRHWJ
謥	YRHWP
謏	YRHXE
諛	YRHXO
誽	YRHXU
謕	YRHYU
誏	YRIAV
??	YRID
諴	YRIHR
誠	YRIHS
諓	YRII
誧	YRIJB
訹	YRIJC
??	YRIKF
詙	YRIKK
訧	YRIKU
詶	YRILL
詠	YRINE
誒	YRIOK
諮	YRIOR
試	YRIPM
貽	YRIR
誡	YRIT
譧	YRITC
謶	YRITF
計	YRJ
謓	YRJBC
誖	YRJBD
諵	YRJBJ
誼	YRJBM
詫	YRJHP
讅	YRJHW
譓	YRJIP
嘲	YRJJB
諸	YRJKA
??	YRJKF
??	YRJLO
??	YRJMD
??	YRJMF
諠	YRJMM
詑	YRJP
詁	YRJR
詴	YRKB
詼	YRKF
誑	YRKHG
譇	YRKJA
??	YRKKB
誇	YRKMS
訓	YRLLL
謱	YRLLV
誂	YRLMO
誹	YRLMY
剖	YRLN
訌	YRM
謣	YRMBS
訏	YRMD
評	YRMFJ
逞	YRMG
謜	YRMHF
讈	YRMHM
??	YRMIG
訐	YRMJ
??	YRMJJ
譀	YRMJK
??	YRMJR
語	YRMMR
誫	YRMMV
訂	YRMN
訶	YRMNR
誣	YRMOO
諮	YRMOR
??	YRMRR
諨	YRMRW
諑	YRMSO
??	YRMT
譖	YRMUA
訝	YRMVH
誙	YRMVM
瓿	YRMVN
謤	YRMWF
諲	YRMWG
譚	YRMWJ
証	YRMYM
讂	YRNBE
譫	YRNCR
享	YRND
烹	YRNF
譎	YRNHB
諂	YRNHX
誦	YRNIB
誃	YRNIN
詺	YRNIR
訊	YRNJ
誕	YRNKM
部	YRNL
讔	YRNLP
詭	YRNMU
亨	YRNN
諝	YRNOB
證	YRNOT
謋	YRNQD
讒	YRNRI
??	YRNS
誸	YRNYI
訥	YROB
??	YRODI
誰	YROG
謢	YROGE
譙	YROGF
診	YROHH
詅	YROII
讖	YROIM
??	YROIN
諗	YROIP
謒	YROIR
許	YROJ
敨	YROK
論	YROMB
詮	YROMG
諭	YROMN
譣	YROMO
??	YROMR
諭	YROMV
訖	YRON
訛	YROP
詐	YROS
譕	YROTF
誨	YROWY
??	YRP
詢	YRPA
訑	YRPD
??	YRPHH
謐	YRPHT
譺	YRPKO
諧	YRPPA
??	YRPR
詍	YRPT
諜	YRPTD
訰	YRPU
??	YRPUK
謅	YRPUU
誄	YRQD
譿	YRQJP
請	YRQMB
謮	YRQMC
諘	YRQMV
??	YRQOA
??	YRQOC
??	YRRHU
譟	YRRRD
譂	YRRRJ
諤	YRRRS
遻	YRRS
諿	YRRSJ
遻	YRRU
譔	YRRUC
襄	YRRV
誤	YRRVK
譝	YRRXU
遐	YRSE
訒	YRSHI
詔	YRSHR
??	YRSHX
譅	YRSIM
認	YRSIP
諏	YRSJE
讘	YRSJJ
謵	YRSMA
??	YRSME
誆	YRSMG
謬	YRSMH
詡	YRSMM
詞	YRSMR
謳	YRSRR
詎	YRSS
記	YRSU
誋	YRSUP
謘	YRSYJ
??	YRTA
??	YRTAJ
謨	YRTAK
譪	YRTAV
譾	YRTBM
??	YRTBN
譜	YRTCA
謚	YRTCT
議	YRTGI
諾	YRTKR
讌	YRTLF
??	YRTLK
謹	YRTLM
??	YRTLO
詌	YRTM
譜	YRTMA
諆	YRTMC
謀	YRTMD
譁	YRTMJ
諶	YRTMV
護	YRTOE
??	YRTOR
詳	YRTQ
讙	YRTRG
誁	YRTT
講	YRTTB
??	YRTWD
譐	YRTWI
譨	YRTWV
謙	YRTXC
謊	YRTYU
訕	YRU
選	YRUC
??	YRUK
諯	YRUMB
??	YRUOB
詘	YRUU
??	YRVE
譏	YRVII
詏	YRVIS
??	YRVL
??	YRW
謂	YRWB
謖	YRWCE
課	YRWD
譯	YRWLJ
諰	YRWP
讄	YRWWW
訃	YRY
諦	YRYBB
讞	YRYBK
謗	YRYBS
謫	YRYCB
詨	YRYCK
譈	YRYDK
敁	YRYE
謎	YRYFD
諔	YRYFE
註	YRYG
諺	YRYHH
訪	YRYHS
識	YRYIA
謰	YRYJJ
??	YRYK
諺	YRYKH
??	YRYLM
譴	YRYLR
訿	YRYMP
??	YRYMU
誶	YRYOJ
謼	YRYPD
謔	YRYPM
??	YRYPN
諕	YRYPU
詀	YRYR
謞	YRYRB
諄	YRYRD
諒	YRYRF
譹	YRYRO
讓	YRYRV
諳	YRYTA
??	YRYTJ
謧	YRYUB
該	YRYVO
??	YRYVU
譠	YRYWM
謫	YRYYB
迉	YS
遲	YSEQ
褭	YSFV
??	YSG
??	YSHML
迢	YSHR
??	YSIHS
与	YSM
瓬	YSMVN
邡	YSNL
??	YSNMU
??	YSO
旃	YSOBY
旓	YSOFB
旟	YSOHC
旂	YSOHL
旌	YSOHM
斻	YSOHN
旄	YSOHU
旅	YSOHV
旛	YSOHW
旆	YSOJB
放	YSOK
旖	YSOKR
旐	YSOLO
旚	YSOMF
斿	YSOND
旋	YSONO
旝	YSOOA
旍	YSOOI
族	YSOOK
施	YSOPD
旎	YSOSP
旗	YSOTC
於	YSOY
??	YSOYM
旒	YSOYU
迡	YSP
??	YSQF
避	YSRJ
??	YSSMV
旞	YSYOO
立	YT
音	YTA
竟	YTAHU
章	YTAJ
意	YTAP
竭	YTAPV
??	YTBGR
??	YTBQR
竫	YTBSD
??	YTCIM
遒	YTCW
??	YTCWA
竦	YTDL
鸕	YTHAF
??	YTHJ
??	YTHL
颯	YTHNI
??	YTHQU
??	YTHSB
??	YTHT
道	YTHU
戲	YTI
竣	YTICE
??	YTIOK
辛	YTJ
??	YTJII
竤	YTJKI
佇	YTJMN
??	YTJR
送	YTK
竑	YTKI
??	YTKMR
逽	YTKR
顱	YTMBC
??	YTNI
??	YTNL
??	YTNR
遳	YTOG
??	YTPA
遂	YTPO
竘	YTPR
靖	YTQMB
翊	YTSMM
竮	YTSTT
迸	YTT
遘	YTTB
??	YTTMC
逆	YTU
溯	YTUB
端	YTUMB
妾	YTV
遭	YTWA
邁	YTWB
童	YTWG
遵	YTWI
站	YTYR
??	YTYT
??	YTYTT
辿	YU
齦	YUAV
齟	YUBM
贙	YUBUC
覤	YUBUU
導	YUDI
叡	YUE
鷲	YUHAF
彪	YUHHH
??	YUHJ
齲	YUHLB
齗	YUHML
??	YUHQU
齯	YUHXU
虥	YUII
齝	YUIR
齻	YUJBC
离	YUKB
齮	YUKMR
??	YULN
齥	YULWP
遄	YUMB
齬	YUMMR
齖	YUMVH
??	YUNL
齡	YUOII
??	YUOK
虪	YUOLF
齘	YUOLL
齕	YUON
齔	YUP
齣	YUPR
齙	YUPRU
齛	YUPT
齺	YUPUU
齞	YURC
齶	YURRS
齪	YURYO
齠	YUSHR
齱	YUSJE
齷	YUSMG
齰	YUTA
齸	YUTCT
甝	YUTM
齫	YUWD
齵	YUWLB
??	YUYCK
齴	YUYHH
??	YUYKH
齜	YUYMP
虤	YUYPU
競	YUYTU
亡	YV
??	YVAB
肓	YVB
裔	YVBCR
牽	YVBQ
盲	YVBU
杗	YVD
壅	YVGG
甕	YVGN
罋	YVGU
饔	YVGV
衁	YVHBT
雍	YVHG
巟	YVHLU
亥	YVHO
瓤	YVHVO
玄	YVI
畜	YVIW
勷	YVKS
??	YVLII
逯	YVNE
邙	YVNL
賌	YVOC
忘	YVP
氓	YVRVP
妄	YVV
巡	YVVV
??	YWA
裹	YWDV
裏	YWGV
??	YWHE
鹹	YWIHR
鹵	YWII
遇	YWLB
遝	YWLE
邏	YWLG
還	YWLV
衰	YWMV
鄐	YWNL
畝	YWNO
鹼	YWOMO
迴	YWR
稟	YWRD
稟	YWRF
亶	YWRM
卣	YWS
鹺	YWTQM
齊	YX
??	YXB
齍	YXBT
齎	YXBUC
??	YXC
??	YXD
齌	YXF
??	YXFD
??	YXHD
劑	YXLN
齏	YXLSM
??	YXV
??	YXWLL
卞	YY
逴	YYAJ
??	YYBB
遉	YYBC
適	YYCB
??	YYHH
迒	YYHN
??	YYKH
跡	YYLC
這	YYMR
遽	YYPO
迠	YYR
遊	YYSD
??	YYTA
遧	YYTJ
邅	YYWM
逌	YYWS
「	YYYAA
」	YYYAB
『	YYYAC
』	YYYAD
〈	YYYAE
〉	YYYAF
《	YYYAG
》	YYYAH
（	YYYAI
）	YYYAJ
〖	YYYAK
〗	YYYAL
【	YYYAM
】	YYYAN
〔	YYYAO
〕	YYYAP
｛	YYYAQ
｝	YYYAR
→	YYYAS
←	YYYAT
↓	YYYAU
↗	YYYAV
↘	YYYAW
↖	YYYAX
↙	YYYAY
△	YYYBA
▲	YYYBB
▽	YYYBC
▼	YYYBD
◇	YYYBE
◆	YYYBF
□	YYYBG
■	YYYBH
☆	YYYBI
★	YYYBJ
○	YYYBK
●	YYYBL
⊙	YYYBM
◎	YYYBN
×	YYYBO
※	YYYBP
♂	YYYBQ
♀	YYYBR
§	YYYBS
’	YYYBT
‘	YYYBU
”	YYYBV
“	YYYBW
￥	YYYBX
・	YYYBY
⊕	YYYCA
℅	YYYCB
￠	YYYCC
￡	YYYCD
℃	YYYCE
℉	YYYCF
°	YYYCG
÷	YYYDA
±	YYYDB
≦	YYYDC
≧	YYYDD
≠	YYYDE
√	YYYDF
=	YYYDG
∞	YYYDH
≒	YYYDI
≡	YYYDJ
∼	YYYDK
∪	YYYDL
∩	YYYDM
∠	YYYDN
⊿	YYYDO
∫	YYYDP
∮	YYYDQ
∵	YYYDR
∴	YYYDS
∗	YYYDT
Ⅱ	YYYGA
Ⅲ	YYYGB
Ⅳ	YYYGC
Ⅵ	YYYGD
Ⅶ	YYYGE
Ⅷ	YYYGF
Ⅸ	YYYGG
〡	YYYGH
〢	YYYGI
〣	YYYGJ
〥	YYYGK
〦	YYYGL
〧	YYYGM
〨	YYYGN
ㄅ	YYYXA
ㄆ	YYYXB
ㄇ	YYYXC
ㄈ	YYYXD
ㄉ	YYYXE
ㄊ	YYYXF
ㄋ	YYYXG
ㄌ	YYYXH
ㄍ	YYYXI
ㄎ	YYYXJ
ㄏ	YYYXK
ㄐ	YYYXL
ㄑ	YYYXM
ㄒ	YYYXN
ㄓ	YYYXO
ㄔ	YYYXP
ㄕ	YYYXQ
ㄖ	YYYXR
ㄗ	YYYXS
ㄘ	YYYXT
ㄙ	YYYXU
ㄧ	YYYXV
ㄨ	YYYXW
ㄩ	YYYXX
ㄚ	YYYXY
ㄛ	YYYYA
ㄜ	YYYYB
ㄝ	YYYYC
ㄞ	YYYYD
ㄟ	YYYYE
ㄠ	YYYYF
ㄡ	YYYYG
ㄢ	YYYYH
ㄣ	YYYYI
ㄤ	YYYYJ
ㄥ	YYYYK
ㄦ	YYYYL
ˊ	YYYYM
ˇ	YYYYN
ˋ	YYYYO
