此碼表存在強制 Big-5 化問題，由於沒有掃描原稿，無法完全修正。

字符	87 五代	註釋
日	a
曰	a
昌	aa
昍	aa
晶	aaa
暘	aamh
晹	aaph
暍	aapv
曝	aate
暻	aayf
明	ab
暝	abac
曖	abbe
盟	abbt
鷳	abhaf
猒	abik
曌	abjcm
暉	abjj
暈	abjj
暖	abme
勗	abms
暩	abof
冒	abu
晛	abuu
暡	acim
晜	acnh
昐	acsh
杲	ad
鷴	adhaf
晰	adhl
時	adi
暐	admq
暕	adwf
鄤	aenl
炅	af
炚	af
曭	afbf
暽	afdq
晱	aff
影	afhhh
顯	afmbc
顥	afmbc
晃	afmu
歞	afno
曀	agbt
時	agdi
曉	aggu
晌	ahbr
晑	ahbr
眉	ahbu
昄	ahe
曛	ahgf
昴	ahhl
剔	ahln
昕	ahml
暀	ahog
暰	ahoo
晷	ahor
星	ahqm
昳	ahqo
昈	ahs
曒	ahsk
昇	aht
昂	ahvl
晲	ahxu
晷	ahyr
晙	aice
晟	aihs
晡	aijb
既	aimvu
昹	aine
即	aisl
曠	aitc
早	aj
暔	ajbj
昧	ajd
暷	ajii
暑	ajka
暄	ajmm
晥	ajmu
晼	ajnu
晏	ajv
旲	ak
暸	akcf
晞	akkb
昦	akll
晻	aklu
晇	akms
旯	akn
映	albk
堲	alg
昲	alln
晁	almo
曊	alnc
旦	am
晅	amam
曘	ambb
暊	ambc
曤	ambg
曇	ambi
晒	amcw
旴	amd
旺	amg
鴠	amhaf
毾	amhqu
戥	ami
晊	amig
旱	amj
旰	amj
昊	amk
昮	amks
晸	ammk
曬	ammp
晤	ammr
晨	ammv
昃	amo
昺	amob
昜	amsh
曞	amtb
量	amwg
曋	amwj
是	amyo
門	an
間	ana
閶	anaa
闒	anasm
晚	anau
冕	anau
閺	anayk
閒	anb
閿	anbbe
閻	anbhx
闅	anbue
闃	anbuk
閱	ancru
閑	and
閉	andh
闈	andmq
闌	andwf
闊	anehr
焛	anf
闛	anfbg
闣	anfbw
閨	angg
闔	angit
昅	anhe
閣	anher
閏	anhg
閽	anhpa
閐	anhqu
闑	anhud
闃	anhuk
閰	anhx
閬	aniav
閾	anirm
閞	anit
闐	anjbc
闍	anjka
閎	anki
閹	anklu
闠	anlmc
閩	anlmi
閂	anm
閛	anmfj
閏	anmg
閈	anmj
闞	anmjk
閆	anmmm
閜	anmnr
開	anmt
闉	anmwg
閻	annhx
閮	annkg
闋	annok
閃	ano
欥	ano
閵	anog
閥	anoi
暌	anok
閤	anomr
闟	anorm
悶	anp
閟	anph
闚	anqou
問	anr
閭	anrhr
闡	anrrj
闆	anrrr
聞	ansj
闖	ansqf
闢	ansrj
鬨	antc
闀	antcu
闕	antuo
闓	anumt
關	anvit
閫	anwd
閘	anwl
闤	anwlv
闥	anygq
閌	anyhn
閍	anyhs
鬥	anyj
閔	anyk
鬧	anylb
誾	anymr
閼	anysy
闇	anyta
閡	anyvo
韙	aodmq
尟	aofh
鶗	aohaf
昤	aoii
昑	aoin
題	aombc
匙	aop
昨	aos
晦	aowy
易	aphh
昒	aphh
旳	api
昀	apim
昆	app
昫	apr
旽	apu
曷	apvo
暙	aqka
晴	aqmb
照	arf
煦	arf
冔	armd
暺	arrj
曮	arrk
暇	arse
煚	asf
昭	ashr
最	asje
曜	asmg
昵	asp
暱	astr
暯	atak
晪	atbc
曚	atbo
暴	atce
謈	atcr
曦	atgs
暪	atlb
曣	atlf
暵	atlo
曄	atmj
巴	au
旵	au
暨	auam
塈	aug
毷	auhqu
勖	auks
暟	aumt
郿	aunl
鱀	aunwf
岊	auu
昢	auu
艮	av
鶡	avhaf
鷃	avhaf
鷐	avhaf
曏	avhl
毼	avhqu
歇	avno
曙	awla
曼	awle
曨	aybp
暾	aydk
昉	ayhs
旻	ayk
旼	ayk
晬	ayoj
暠	ayrb
景	ayrf
晾	ayrf
曩	ayrv
暆	aysd
昱	ayt
暗	ayta
曈	aytg
暲	aytj
昡	ayvi
月	b
腥	bahm
膽	bam
腸	bamh
肥	bau
冥	bayc
朋	bb
骨	bbb
腡	bbbr
覶	bbbuu
骳	bbdhe
脟	bbdi
受	bbe
髐	bbggu
鶻	bbhaf
骼	bbher
鵬	bbhf
骰	bbhne
髀	bbhwj
髆	bbibi
髍	bbijc
髂	bbjhr
髕	bbjmc
骷	bbjr
髖	bbjti
骻	bbkms
骫	bbkni
髏	bbllv
剮	bbln
冊	bbm
顝	bbmbc
骭	bbmj
骾	bbmlk
胴	bbmr
脬	bbnd
舜	bbnq
骱	bboll
愛	bbpe
咼	bbr
髒	bbtmt
髊	bbtqm
骿	bbtt
體	bbtwt
亂	bbu
臞	bbug
鼏	bbul
覓	bbuu
髁	bbwd
髑	bbwli
骹	bbyck
骯	bbyhn
髓	bbykb
骴	bbymp
髇	bbyrb
辭	bbytj
骸	bbyvo
賵	bcabu
賜	bcaph
贔	bcbcc
賝	bcbcd
賙	bcbgr
賱	bcbjj
賙	bcbqr
賏	bcbuc
覭	bcbuu
贈	bccwa
財	bcdh
賧	bcff
贖	bcgwc
鵙	bchaf
販	bche
賂	bcher
貶	bchio
貾	bchpm
貹	bchqm
賻	bcibi
贓	bcig
賤	bcii
贂	bciih
賊	bcij
賕	bcije
贆	bcikk
贓	bcims
貽	bcir
肸	bcj
賳	bcjir
賭	bcjka
貯	bcjmn
賄	bckb
賗	bcll
贐	bclmt
則	bcln
罕	bcmj
賑	bcmmv
賦	bcmpm
甖	bcmvn
贉	bcmwj
贍	bcncr
鄍	bcnl
郥	bcnl
罌	bcoju
敗	bcok
賒	bcomf
貤	bcpd
賰	bcqka
冏	bcr
貺	bcrhu
腳	bcrl
脫	bcru
鼆	bcrxu
賬	bcsmv
賟	bctbc
賹	bctct
購	bcttb
賺	bctxc
嬰	bcv
貥	bcyhn
譻	bcymr
賥	bcyoj
貼	bcyr
賠	bcytr
賅	bcyvo
采	bd
彩	bdhhh
肘	bdi
郛	bdnl
膝	bdoe
乳	bdu
腏	beee
鶢	behaf
炙	bf
膛	bfbg
膌	bfcb
冞	bfd
膦	bfdq
縣	bfhvf
胱	bfmu
懸	bfp
胖	bfq
賸	bfqc
滕	bfqe
騰	bfqf
縢	bfqf
塍	bfqg
螣	bfqi
謄	bfqr
勝	bfqs
腃	bfqu
媵	bfqv
乿	bfu
肚	bg
膮	bggu
氍	bghqu
胠	bgi
腳	bgil
周	bgr
臌	bgte
膨	bgth
胉	bha
腺	bhae
貜	bhbue
貕	bhbvk
豺	bhdh
腇	bhdv
膰	bhdw
胳	bher
臐	bhgf
貌	bhhau
貉	bhher
肜	bhhh
脈	bhhv
貏	bhhwj
貔	bhhwp
貌	bhhxu
貁	bhjc
腶	bhje
腫	bhjg
腄	bhjm
腯	bhju
貗	bhllv
貄	bhlq
貊	bhma
貆	bhmam
豻	bhmj
肵	bhml
肌	bhn
冗	bhn
股	bhne
為	bhnf
豽	bhob
貅	bhod
貐	bhomn
胻	bhon
豹	bhpi
胝	bhpm
胜	bhqm
胅	bhqo
貚	bhrrj
貑	bhrse
貂	bhshr
貙	bhsrr
貘	bhtak
貓	bhtw
臢	bhuc
貒	bhumb
貀	bhuu
膬	bhuu
胍	bhvo
貍	bhwg
脾	bhwj
膍	bhwp
舀	bhx
腴	bhxo
膊	bibi
朘	bice
脯	bijb
脙	bije
胈	bikk
脈	bine
腑	bioi
膩	bipc
臕	bipf
胎	bir
虢	biypu
肺	bjb
脖	bjbd
腩	bjbj
膣	bjcg
腔	bjcm
皸	bjdhe
肢	bje
鶤	bjhaf
膞	bjii
蠈	bjlmi
顐	bjmbc
臏	bjmc
脘	bjmu
鄆	bjnl
腕	bjnu
膹	bjtc
臗	bjti
胺	bjv
軍	bjwj
膫	bkcf
谿	bkcor
然	bkf
鶪	bkha
雞	bkhaf
肱	bki
网	bkk
腌	bklu
胯	bkms
胰	bkn
肒	bkni
郹	bknl
雞	bkog
脥	bkoo
肋	bks
脅	bkss
胦	blbk
胇	blln
膢	bllv
朓	blmo
腓	blmy
刖	bln
胂	blwl
胏	blxh
且	bm
肛	bm
囗	bm
臑	bmbb
臛	bmbg
胹	bmbl
胚	bmfm
胵	bmig
肝	bmj
爰	bmke
助	bmks
刪	bmln
刞	bmln
具	bmmc
冢	bmmo
朊	bmmu
脤	bmmv
雎	bmog
同	bmr
膈	bmrb
脰	bmrt
腷	bmrw
豚	bmso
塚	bmso
冠	bmui
脛	bmvm
膘	bmwf
靦	bmwl
腰	bmwv
肊	bn
冤	bnai
脆	bnau
脕	bnau
膽	bncr
孚	bnd
膙	bnii
脡	bnkg
腱	bnkq
蠫	bnlii
脆	bnmu
腹	boae
肭	bob
朒	bobo
胕	bodi
脽	bog
膲	bogf
臇	bogs
胗	bohh
肣	boin
腍	boip
膾	boma
祭	bommf
腧	bomn
臉	bomo
豋	bomrt
肐	bon
脞	boog
胣	bopd
胙	bos
膴	botf
脢	bowy
脂	bpa
吻	bphr
朐	bpr
胞	bpru
肫	bpu
胸	bpuk
用	bq
腠	bqkk
膆	bqmf
周	bqr
甩	bqu
胑	brc
鵰	brhaf
脭	brhg
彫	brhhh
戙	bri
雕	brog
臊	brrd
齶	brrs
翢	brsmm
爭	bsd
鵩	bsef
豸	bshh
肕	bshi
腒	bsjr
服	bsle
腛	bsmg
膠	bsmh
脹	bsmv
凸	bss
皿	bt
冊	bt
腊	bta
冪	btab
膜	btak
腆	btbc
朦	btbo
膉	btct
膳	btgr
臟	btis
朕	btk
臙	btlf
朠	btlk
刪	btln
頯	btmbc
腜	btmd
臒	btoe
胼	btt
岡	btu
膿	btwv
賺	btxc
膵	btyj
罔	btyv
目	bu
睅	buamj
睼	buamo
瞷	buana
矙	buank
眼	buav
瞑	bubac
曖	bubbe
瞬	bubbq
睬	bubd
睭	bubgr
睜	bubsd
覞	bubu
瞁	bubuk
睍	bubuu
貝	buc
朡	buce
瞈	bucim
盻	bucms
睇	bucnh
盼	bucsh
睞	budoo
睄	bufb
矘	bufbf
瞠	bufbg
眯	bufd
瞵	bufdq
睒	buff
眇	bufh
睠	bufqu
睖	bugce
睦	bugcg
眭	bugg
瞌	bugit
鷂	buhaf
瞗	buhaf
瞅	buhdf
眅	buhe
矄	buhgf
眽	buhhv
眨	buhio
睡	buhjm
瞃	buhju
盺	buhml
颻	buhni
覹	buhok
瞛	buhoo
睧	buhpa
睋	buhqi
眣	buhqo
眊	buhqu
睙	buhsk
見	buhu
矏	buhus
繇	buhvf
睥	buhwj
瞍	buhxe
睨	buhxu
眸	buihq
狊	buik
眙	buir
矌	buitc
眓	buiv
瞋	bujbc
眛	bujd
睹	bujka
睫	bujlo
矉	bujmc
瞚	bujmc
眝	bujmn
睆	bujmu
睕	bujnu
瞎	bujqr
瞭	bukcf
睎	bukkb
眱	bukn
眈	bulbu
瞣	bullp
瞜	bullv
瞶	bulmc
蜰	bulmi
眺	bulmo
剛	buln
眒	bulwl
矐	bumbg
盱	bumd
睚	bumgg
盰	bumj
瞰	bumjk
眄	bumls
眃	bummi
盯	bumn
瞟	bumwf
瞫	bumwj
眐	bumym
睌	bunau
矎	bunbe
瞻	buncr
瞲	bunhb
眵	bunin
眳	bunir
睽	bunok
瞪	bunot
瞿	buog
睢	buog
膗	buog
矍	buoge
瞧	buogf
眕	buohh
瞺	buoma
睔	buomb
睮	buomn
瞼	buomo
盵	buon
瞴	buotf
眴	bupa
盷	bupim
盹	bupu
睛	buqmb
瞡	buqou
睊	burb
矂	burrd
眠	burvp
矚	busei
眧	bushr
眲	busj
眶	busmg
瞙	butak
矇	butbo
瞨	butco
眹	butk
瞞	butlb
瞱	butmj
眻	butq
矔	butrg
瞄	butw
朏	buu
矊	buvfb
眑	buvis
鼎	buvml
睩	buvne
睏	buwd
矓	buybp
瞇	buyfd
睟	buyoj
瞳	buytg
瞕	buytj
瞝	buyub
盳	buyv
眩	buyvi
妥	bv
墾	bvg
鸚	bvhaf
膷	bvhl
奚	bvik
郻	bvnl
腞	bvno
懇	bvp
臘	bvvv
腦	bvvw
膕	bwim
胭	bwk
胛	bwl
腢	bwlb
爵	bwli
臅	bwli
腲	bwmv
膃	bwot
腮	bwp
丹	by
腿	byav
膼	bybb
朧	bybp
膀	bybs
鴅	byhaf
彤	byhhh
肮	byhn
膇	byhr
肪	byhs
膱	byia
膟	byij
肺	bylb
刐	byln
脺	byoj
腋	byok
臄	bypo
臚	bypt
脝	byrn
腤	byta
朣	bytg
雘	bytoe
臆	bytp
臃	byvg
胘	byvi
胲	byvo
膻	bywm
臍	byx
金	c
鈤	ca
錩	caa
鎤	cafu
鉭	cam
鍚	camh
銲	camj
鍉	camo
甑	camvn
鍆	can
鐧	cana
鄫	canl
鑭	canw
錫	caph
錕	capp
鍻	capv
鎉	casm
鑤	cate
鈀	cau
銀	cav
鏝	cawe
鈅	cb
錋	cbb
鑀	cbbe
鍋	cbbr
鍘	cbcn
鋝	cbdi
錭	cbgr
鍕	cbjj
鉏	cbm
鍰	cbme
銅	cbmr
鋤	cbms
錚	cbsd
鋼	cbtu
鉬	cbu
鋇	cbuc
钁	cbue
鋧	cbuu
鑫	ccc
鈆	cci
銻	ccnh
鋊	ccor
鉛	ccr
銳	ccru
鈖	ccsh
釮	cdh
鈹	cdhe
鈌	cdk
鋉	cdl
缽	cdm
鍏	cdmq
錸	cdoo
鍊	cdwf
錔	cea
鐋	ceah
鎟	ceed
錣	ceee
鎃	cehv
釵	cei
鈥	cf
銷	cfb
鎖	cfbc
鏿	cfbd
钂	cfbf
鏜	cfbg
鋿	cfbr
鎲	cfbu
鐺	cfbw
銤	cfd
鏻	cfdq
錟	cff
鑅	cffd
鐒	cffs
鈔	cfh
銧	cfmu
鉡	cfq
錈	cfqu
釷	cg
錂	cgce
錴	cgcg
銈	cgg
鐃	cggu
鉣	cgi
鎑	cgit
鑄	cgni
鋕	cgp
銡	cgr
鎱	cgrv
鉑	cha
錦	chab
鍠	chag
鉌	chd
鏼	chdb
鍬	chdf
鋓	chdn
銹	chds
鐇	chdw
鈑	che
鋒	chej
鉻	cher
鉖	chey
銩	chgi
鋯	chgr
銑	chgu
鵜	chhaf
鳻	chhaf
鑗	chhe
釤	chhh
鉚	chhl
鎦	chhw
銖	chjd
鍛	chje
鍾	chjg
錘	chjm
銛	chjr
鍎	chju
鍤	chjx
鑕	chlc
剃	chln
釽	chlo
頒	chmbc
釿	chml
銗	chmr
釩	chni
邠	chnl
鉛	chnr
攽	chok
鏦	choo
錉	chpa
鋨	chqi
鉎	chqm
鐵	chqo
鎢	chrf
鑽	chuc
鎳	chud
鎴	chup
鈲	chvo
錍	chwj
鎞	chwp
鎪	chxe
銵	chxh
公	ci
鋃	ciav
鎛	cibi
鋑	cice
鏚	cihf
銊	cihm
鉾	cihq
鍼	cihr
鋮	cihs
鈗	cihu
錢	cii
鏒	ciih
鎯	ciil
鋪	cijb
鉥	cijc
銶	cije
鈸	cikk
鏞	cilb
鏮	cile
銂	cill
鎕	cilr
頌	cimbc
瓮	cimn
銢	cine
釴	cip
鑣	cipf
鉽	cipm
鋱	cipp
鈶	cir
翁	cism
礦	citc
鐮	citc
鍍	cite
鏣	citf
鉞	civ
鏕	cixp
針	cj
鎮	cjbc
鋍	cjbd
鎍	cjbf
鎔	cjcr
鐵	cjig
鏄	cjii
鏸	cjip
鍺	cjka
鋐	cjki
銠	cjkp
銬	cjks
鑌	cjmc
鏔	cjmc
錝	cjmf
鍹	cjmm
錠	cjmo
鎵	cjmo
鋎	cjmu
鋺	cjnu
鉈	cjp
鑏	cjpn
鈷	cjr
錧	cjrr
鐼	cjtc
鑳	cjto
銨	cjv
父	ck
釱	ck
爸	ckau
銪	ckb
鎩	ckce
鐐	ckcf
鎩	ckde
鍷	ckgg
斧	ckhml
鈜	cki
鈦	cki
錛	ckjt
鈽	cklb
銌	ckld
錼	ckmf
釜	ckmgc
錡	ckmr
銙	ckms
銕	ckn
釚	ckn
爹	cknin
鋏	ckoo
爺	cksjl
丫	cl
鉠	clbk
鈂	clbu
釧	clll
鏤	cllv
鐀	clmc
銚	clmo
釗	cln
鐨	clnc
鈾	clw
鏽	clx
釭	cm
銆	cma
鑐	cmbb
顉	cmbc
鐳	cmbw
釪	cmd
鑈	cmfb
鋄	cmfe
銔	cmfj
鈺	cmgi
鑩	cmgr
鶲	cmhaf
銍	cmig
釬	cmj
鉶	cmjn
錏	cmlm
鋙	cmmr
釫	cmms
鋠	cmmv
釘	cmn
鈳	cmnr
憌	cmp
鉐	cmr
鎘	cmrb
鋀	cmrt
鈃	cmt
鉶	cmtn
鐕	cmua
鎒	cmvi
鋞	cmvm
兮	cmvs
鏢	cmwf
鐔	cmwj
鉦	cmym
鈣	cmys
釔	cn
鐌	cnao
銫	cnau
釨	cnd
錳	cndt
鈕	cng
鐍	cnhb
鍒	cnhd
鈒	cnhe
釢	cnhs
錎	cnhx
釸	cni
鏹	cnii
鉹	cnin
銘	cnir
鋌	cnkg
鋋	cnkm
鍵	cnkq
鈏	cnl
弚	cnl
弟	cnlh
鐊	cnlh
錒	cnlr
釕	cnn
欽	cno
鏺	cnoe
鐙	cnot
鑱	cnri
鍑	coae
鈉	cob
銝	cod
錐	cog
鏶	cogd
鐎	cogf
鎨	cogj
鐫	cogs
銋	cohg
鈴	coii
鑯	coim
鈐	coin
鎗	coir
鋡	coir
鉓	colb
鎀	colh
螸	colmi
鑰	comb
銓	comg
鐱	como
鉿	comr
釳	con
鎎	cond
鍭	conk
銼	coog
慾	cop
谷	cor
鋂	cowy
鈊	cp
鉍	cph
釣	cpi
鉤	cpi
鈞	cpim
鈞	cpmm
鋾	cpou
鈚	cpp
鍇	cppa
鉤	cpr
鉋	cpru
鍱	cptd
鈍	cpu
鍧	cpyr
銇	cqd
鍥	cqhk
鏏	cqjm
錆	cqmb
錶	cqmv
鈇	cqo
釦	cr
鋗	crb
鵒	crhaf
鋁	crhr
兌	crhu
谾	crjcm
谹	crki
豃	crmjk
郤	crnl
欲	crno
谻	crnq
谽	croir
懖	crp
鐰	crrd
鍔	crrs
鍜	crse
卻	crsl
豂	crsmh
谼	crtc
鐉	cruc
鋘	crvk
鈱	crvp
豅	crybp
鏗	cseg
钃	csei
分	csh
貧	cshc
炃	cshf
坌	cshg
忿	cshp
鉊	cshr
盆	csht
弅	csht
岔	cshu
鑑	csit
鉺	csj
鋷	csje
鑷	csjj
鋸	csjr
鉔	cslb
鋟	csme
鏐	csmh
鉰	csmr
鑑	csmt
鋹	csmv
鈮	csp
鎷	csqf
鏂	csrr
鉅	css
鋦	cssr
錯	cta
鏌	ctak
錪	ctbc
鏾	ctbk
鐠	ctca
鏷	ctco
鎰	ctct
鑮	ctei
鑆	ctgi
鎂	ctgk
鑉	ctgt
錓	ctgu
鑶	ctis
鉗	ctm
鐠	ctma
錤	ctmc
鏵	ctmj
鍖	ctmv
鑊	ctoe
錵	ctop
鎝	ctor
鐷	ctpd
鎈	ctqm
鑵	ctrg
鍣	ctsr
鉼	ctt
鎙	ctub
鎡	ctvi
錨	ctw
鐏	ctwi
鎌	ctxc
鑝	ctyj
鋩	ctyv
釓	cu
鍐	cuce
毤	cuhqu
錌	cumj
鎧	cumt
鑴	cuob
鏙	cuog
敓	cuok
釹	cv
鐑	cvfr
鑠	cvid
鐖	cvii
鉯	cvio
鏘	cvmi
錄	cvne
銣	cvr
鑞	cvvv
錙	cvvw
鈿	cw
曾	cwa
錁	cwd
鋰	cwg
錮	cwjr
銦	cwk
鉀	cwl
鑼	cwlg
鐲	cwli
鐸	cwlj
鐶	cwlv
鍡	cwmv
鍶	cwp
鏎	cwtj
鏍	cwvf
鑸	cwwg
鉧	cwyi
釙	cy
鍗	cybb
鐹	cybb
鍞	cybc
钀	cybk
鑨	cybp
鎊	cybs
鏑	cycb
鉸	cyck
鐓	cydk
鈙	cye
鉒	cyg
鐽	cygq
鏟	cyhm
鈧	cyhn
鎚	cyhr
鈁	cyhs
銥	cyhv
錥	cyib
銃	cyiu
鈄	cyj
鏈	cyjj
鏟	cykm
鈰	cylb
錹	cymb
鐬	cymh
鉲	cymy
鏬	cypd
鐻	cypo
鑢	cypp
鐪	cyps
鑪	cypt
鉆	cyr
鎬	cyrb
錞	cyrd
鑲	cyrv
鏃	cysk
鏇	cyso
鐘	cytg
鋅	cytj
鐩	cyto
鐿	cytp
鏡	cytu
鉉	cyvi
鏀	cywi
鑇	cyx
木	d
杳	da
榥	dafu
榯	dagi
楣	dahu
楖	dail
概	daiu
查	dam
柦	dam
楊	damh
桿	damj
橍	dang
櫚	danr
欄	danw
棍	dapp
楬	dapv
榻	dasm
杷	dau
根	dav
槾	dawe
朿	db
榠	dbac
棚	dbb
榾	dbbb
柵	dbbm
棎	dbcd
櫻	dbcv
棌	dbd
棘	dbdb
棗	dbdb
椆	dbgr
槄	dbhx
楎	dbjj
橪	dbkf
刺	dbln
柤	dbm
椇	dbmc
楥	dbme
桐	dbmr
桴	dbnd
僰	dbo
榣	dbou
棦	dbsd
棴	dbse
柵	dbt
棡	dbtu
相	dbu
梖	dbuc
欋	dbug
桵	dbv
榽	dbvk
朳	dc
檭	dcav
椕	dchd
松	dci
棇	dcip
枍	dcms
梯	dcnh
梲	dcru
枌	dcsh
橧	dcwa
林	dd
楂	ddam
栜	ddb
鬱	ddbuh
棼	ddcsh
森	ddd
檚	dddo
櫇	ddec
焚	ddf
埜	ddg
材	ddh
柀	ddhe
彬	ddhh
梵	ddhni
檒	ddhni
村	ddi
麓	ddixp
枺	ddj
樊	ddk
蠜	ddkli
礬	ddkmr
攀	ddkq
梀	ddl
楋	ddln
樕	ddlo
禁	ddmmf
農	ddmmv
椲	ddmq
郴	ddnl
楚	ddnyo
棽	ddoin
棶	ddoo
懋	ddp
婪	ddv
棟	ddw
榃	ddw
楝	ddwf
棳	deee
桫	defh
杈	dei
樑	deid
頗	dembc
皯	demj
皰	depru
杰	df
梢	dfb
橖	dfbd
欓	dfbf
樘	dfbg
橕	dfbh
檔	dfbw
橉	dfdq
棪	dff
橩	dffn
橯	dffs
杪	dfh
隸	dfle
桄	dfmu
柈	dfq
棬	dfqu
杜	dg
柟	dgb
棱	dgce
桂	dgg
槸	dggi
橈	dggu
榼	dgit
檮	dgni
樾	dgov
檣	dgow
桔	dgr
檯	dgrg
榬	dgrv
樹	dgti
櫝	dgwc
才	dh
柏	dha
棉	dhab
楻	dhag
槔	dhaj
櫛	dhal
鼒	dhbul
櫸	dhcq
楸	dhdf
橎	dhdw
皮	dhe
板	dhe
桻	dhej
格	dher
柊	dhey
檓	dhge
梏	dhgr
鸉	dhhaf
杉	dhhh
榭	dhhi
柳	dhhl
榴	dhhw
櫆	dhij
柉	dhio
櫡	dhja
株	dhjd
椴	dhje
棰	dhjm
栝	dhjr
楯	dhju
橋	dhkb
楀	dhlb
櫍	dhlc
析	dhml
梔	dhmu
柝	dhmy
机	dhn
杸	dhne
楓	dhni
杋	dhni
桁	dhon
椼	dhon
樅	dhoo
棔	dhpa
橁	dhpa
柢	dhpm
梆	dhql
柣	dhqo
枆	dhqu
楄	dhsb
檄	dhsk
槴	dhsu
欑	dhuc
槐	dhui
櫋	dhus
橇	dhuu
柧	dhvo
椑	dhwj
楰	dhxo
樦	dhyg
榹	dhyu
寸	di
桹	diav
榑	dibi
梭	dice
櫥	digi
槭	dihf
椷	dihr
棧	dii
槮	diih
榔	diil
梂	dije
柭	dikk
槦	dilb
栦	dill
刌	diln
榶	dilr
栨	dimo
櫠	dine
榳	ding
杙	dip
樲	dipc
栻	dipm
檯	dir
棫	dirm
械	dit
末	dj
槙	djbc
桲	djbd
楠	djbj
植	djbm
柼	djc
椌	djcm
榕	djcr
榨	djcs
枝	dje
楁	djhr
槫	djii
橞	djip
橶	djji
杖	djk
楮	djka
栳	djkp
栲	djks
棲	djlv
檳	djmc
棕	djmf
楦	djmm
椗	djmo
梡	djmu
柁	djp
榰	djpa
檸	djpn
枯	djr
楜	djrb
橭	djrj
棺	djrr
橨	djtc
桉	djv
夬	dk
杕	dk
栯	dkb
樧	dkce
橑	dkcf
楏	dkgg
鷘	dkhaf
梑	dkhf
桸	dkkb
樉	dkkk
栫	dkld
橢	dkmb
椅	dkmr
桍	dkms
整	dkmym
桋	dkn
朹	dkn
槉	dkok
梜	dkoo
憖	dkp
朸	dks
槬	dkso
枷	dksr
檶	dksr
束	dl
柍	dlbk
枕	dlbu
梊	dld
棣	dle
皙	dlha
敕	dlks
鶒	dlksf
蜤	dllmi
剌	dlln
柫	dlln
樓	dllv
樻	dlmc
桃	dlmo
棑	dlmy
賴	dlnbc
欶	dlno
敕	dlok
惁	dlp
賴	dlshc
柚	dlw
柛	dlwl
梬	dlws
橚	dlx
棩	dlxl
本	dm
杠	dm
桓	dmam
檽	dmbb
槓	dmbc
櫌	dmbe
栭	dmbl
欞	dmbo
櫺	dmbr
樗	dmbs
檑	dmbw
栖	dmcw
杅	dmd
極	dmem
杯	dmf
檷	dmfb
枰	dmfj
柸	dmfm
檦	dmfn
桮	dmfr
枉	dmg
櫮	dmgr
梇	dmgt
榞	dmhf
櫪	dmhm
榗	dmia
桎	dmig
杆	dmj
橄	dmjk
梗	dmlk
栦	dmll
椏	dmlm
柰	dmmf
枟	dmmi
欐	dmmp
梧	dmmr
杇	dmms
杬	dmmu
桭	dmmv
朾	dmn
桏	dmnl
栵	dmnn
柯	dmnr
柄	dmob
柘	dmr
韋	dmrq
梪	dmrt
楅	dmrw
翉	dmsmm
椓	dmso
枙	dmsu
枅	dmt
橛	dmto
杌	dmu
榎	dmue
枒	dmvh
桱	dmvm
枑	dmvm
朽	dmvs
舝	dmvvq
檟	dmwc
標	dmwf
槱	dmwf
橝	dmwj
橿	dmwm
橡	dnao
桷	dnbg
槲	dnbj
檞	dnbq
檐	dncr
李	dnd
杍	dnd
槂	dndf
櫯	dnfd
杻	dng
橘	dnhb
楙	dnhd
楺	dnhd
极	dnhe
桶	dnib
栘	dnin
杼	dnin
梃	dnkg
梴	dnkm
楗	dnkq
橢	dnlb
樄	dnlw
桅	dnmu
杴	dno
楈	dnob
楑	dnok
橙	dnot
揧	dnq
榤	dnqd
欃	dnri
楹	dnst
凳	dntn
櫓	dnwa
枘	dob
榷	dobg
賚	dobuc
栴	doby
柎	dodi
桼	doe
椎	dog
樵	dogf
榫	dogj
檇	dogs
鶆	dohaf
柃	doii
猌	doik
櫼	doim
枔	doin
棯	doip
槍	doir
梒	doir
杵	doj
枚	dok
椥	dokr
敕	doks
樇	dolb
檜	doma
棆	domb
梌	domd
栓	domg
楩	domk
榆	domn
檢	domo
榆	domv
杚	don
郲	donl
來	doo
桽	doog
杹	dop
柂	dopd
柞	dos
梅	dowy
檎	doyb
朼	dp
杺	dp
栒	dpa
栺	dpa
杝	dpd
椈	dpfd
柲	dph
榓	dpht
杓	dpi
构	dpi
杓	dpm
枃	dpmm
枇	dpp
楷	dppa
梐	dppg
枸	dpr
枹	dpru
枻	dpt
楪	dptd
杶	dpu
杽	dq
韞	dqabt
韜	dqbhx
韗	dqbjj
韎	dqdj
韥	dqgwc
韟	dqhaj
楔	dqhk
韍	dqikk
梆	dqjl
槥	dqjm
椿	dqka
榛	dqkd
楱	dqkk
棒	dqkq
樁	dqkx
棈	dqmb
樍	dqmc
榡	dqmf
韖	dqnhd
郼	dqnl
枎	dqo
韐	dqomr
槻	dqou
韘	dqptd
韌	dqshi
韔	dqsmv
韡	dqtmj
韝	dqttb
韣	dqwli
韞	dqwot
韕	dqyrd
杏	dr
梋	drb
枳	drc
桯	drhg
梠	drhr
柺	drhs
柷	drhu
枴	drks
枵	drms
橾	drrd
樿	drrj
椵	drse
枴	drsh
楫	drsj
椻	dsav
欘	dsei
樨	dseq
榍	dsfb
檻	dsit
栮	dsj
棷	dsje
椰	dsjl
椐	dsjr
桾	dskr
櫃	dslc
榧	dsly
槢	dsma
梫	dsme
櫂	dsmg
框	dsmg
樛	dsmh
栩	dsmm
柌	dsmr
檻	dsmt
棖	dsmv
樼	dsnd
柩	dsno
柅	dsp
榪	dsqf
梛	dsql
檉	dsrg
樞	dsrr
柜	dss
梮	dssr
榐	dstv
杞	dsu
欖	dswu
棤	dta
模	dtak
欗	dtaw
檬	dtbo
栱	dtc
欉	dtce
樸	dtco
楢	dtcw
欂	dtei
樣	dtge
榚	dtgf
檥	dtgi
檨	dtgo
橏	dtgr
樥	dthj
楛	dtjr
栚	dtk
楉	dtkr
樠	dtlb
橫	dtlc
槿	dtlm
櫹	dtlx
柑	dtm
棋	dtmc
樺	dtmj
椹	dtmv
檴	dtoe
榙	dtor
槆	dtpa
槎	dtqm
權	dtrg
榵	dtsj
櫙	dtsr
栟	dtt
構	dttb
椪	dttc
橏	dttr
槽	dtwa
樽	dtwi
槏	dtxc
札	du
梤	duch
蚻	dulmi
椯	dumb
榿	dumt
欈	duob
梣	duon
想	dup
柮	duu
紮	duvif
櫞	dvfo
櫟	dvid
機	dvii
柪	dvis
朻	dvl
梉	dvmg
椽	dvno
欚	dvoi
樔	dvvd
椔	dvvw
東	dw
柶	dwc
棵	dwd
梱	dwd
柬	dwf
梩	dwg
鶇	dwhaf
棞	dwhd
槶	dwim
棝	dwjr
柙	dwl
欏	dwlg
檡	dwlj
楞	dwls
檌	dwly
椳	dwmv
楒	dwp
樏	dwvf
欙	dwwf
櫑	dwww
朴	dy
棹	dyaj
楴	dybb
檛	dybb
楨	dybc
櫳	dybp
榜	dybs
樀	dycb
校	dyck
橔	dydk
槨	dydl
櫬	dydu
椒	dyfe
柱	dyg
楌	dyhh
杭	dyhn
槌	dyhr
枋	dyhs
樴	dyia
橀	dyit
梳	dyiu
枓	dyj
槤	dyjj
楌	dykh
柿	dylb
檅	dymh
櫏	dymu
橠	dynv
椊	dyoj
榩	dypk
樝	dypm
櫨	dypt
枮	dyr
櫧	dyra
槁	dyrb
椋	dyrf
楟	dyrn
檺	dyro
欀	dyrv
椸	dysd
檹	dysr
棜	dysy
柆	dyt
橦	dytg
樟	dytj
梓	dytj
檖	dyto
檍	dytp
棓	dytr
樈	dytu
檤	dytu
椄	dytv
樆	dyub
核	dyvo
檁	dywd
檀	dywm
櫰	dywv
榱	dywv
櫅	dyx
水	e
汨	ea
沓	ea
淐	eaa
溫	eabt
灦	eafc
灝	eafc
滉	eafu
涅	eag
溡	eagi
湦	eahm
湄	eahu
溉	eaiu
泹	eam
湯	eamh
淂	eami
涆	eamj
淏	eamk
湜	eamo
澗	eana
澗	eanb
澖	eand
灁	eane
潤	eang
灛	eanj
潣	eank
闊	eanr
瀾	eanw
混	eapp
渴	eapv
瀑	eate
濕	eavf
漫	eawe
澋	eayf
溟	ebac
淝	ebau
淜	ebb
滑	ebbb
渦	ebbr
漞	ebbu
深	ebcd
濺	ebci
測	ebcn
浻	ebcr
滘	ebcr
瀴	ebcv
淍	ebgr
淫	ebhg
沉	ebhn
沉	ebhu
滔	ebhx
渾	ebjj
鸂	ebkf
沮	ebm
湲	ebme
濦	ebmp
洞	ebmr
浮	ebnd
漈	ebof
懣	ebp
懘	ebp
泂	ebr
淨	ebsd
淚	ebu
浿	ebuc
灈	ebug
濉	ebug
渺	ebuh
湨	ebuk
濎	ebul
涀	ebuu
浽	ebv
溪	ebvk
灂	ebwi
浵	ebyh
淦	ec
汃	ec
鍙	ecc
滃	ecim
滏	eckc
涕	ecnh
浴	ecor
沿	ecr
涗	ecru
汾	ecsh
湓	ecst
潧	ecwa
沐	ed
渣	edam
盓	edbt
湘	edbu
淞	edci
淋	edd
潸	eddb
澿	eddf
漜	eddg
灪	eddh
滼	eddn
濋	eddo
塗	edg
溎	edgg
波	edhe
淅	edhl
沫	edj
決	edk
涑	edl
瀨	edlc
漱	edlk
漱	edlo
泍	edm
顙	edmbc
渿	edmf
湋	edmq
漆	edoe
淶	edoo
涷	edw
湅	edwf
沝	ee
涾	eea
淼	eee
桑	eeed
敪	eeeee
鵽	eeeef
剟	eeeen
欼	eeeeo
毲	eeeeu
疊	eeem
汊	eei
溞	eeii
碆	eemr
濷	eetb
婆	eev
消	efb
漟	efbg
潎	efbk
淌	efbr
澢	efbw
瀵	efdc
潾	efdq
淡	eff
濴	effe
瀠	efff
瀅	effi
瀯	effr
澇	effs
沙	efh
渻	efhu
洸	efmu
泮	efq
潫	efqf
圣	eg
淩	egce
淕	egcg
濲	egde
瀫	egfe
洼	egg
塣	egg
澆	eggu
法	egi
溘	egit
準	egj
浾	eglc
濤	egni
濇	egow
洁	egr
溒	egrv
滶	egsk
澎	egth
澍	egti
涬	egtj
瀆	egwc
泊	eha
湟	ehag
滜	ehaj
瀄	ehal
澔	ehar
澳	ehbk
淛	ehbn
洫	ehbt
盪	ehbt
洎	ehbu
灚	ehbu
洀	ehby
瀏	ehcn
潲	ehdb
潻	ehde
湫	ehdf
浰	ehdn
溗	ehdp
潘	ehdw
汳	ehe
洚	eheq
洛	eher
瀊	ehet
燙	ehf
浩	ehgr
洗	ehgu
泖	ehhl
派	ehhv
溜	ehhw
泛	ehio
洙	ehjd
湩	ehjg
活	ehjr
沃	ehk
添	ehkp
潷	ehlq
璗	ehmgi
沂	ehml
澨	ehmo
洉	ehmr
硰	ehmr
泝	ehmy
沒	ehne
汎	ehni
渢	ehni
洬	ehnn
沿	ehnr
鯊	ehnwf
澓	ehoe
洐	ehon
漎	ehoo
漇	ehoo
涽	ehpa
泜	ehpm
挲	ehq
涐	ehqi
湃	ehqj
泩	ehqm
泆	ehqo
溮	ehrb
淭	ehsd
激	ehsk
淚	ehsk
滬	ehsu
灒	ehuc
瀩	ehuc
溾	ehui
溴	ehuk
濞	ehul
娑	ehv
泒	ehvo
汦	ehvp
溲	ehxe
潟	ehxf
淣	ehxu
裟	ehyhv
叉	ei
浪	eiav
溥	eibi
浚	eice
灖	eicy
梁	eid
灖	eidy
粱	eifd
滅	eihf
洠	eihq
減	eihr
沇	eihu
淺	eii
滲	eiih
浦	eijb
沭	eijc
汱	eik
溈	eikf
沷	eikk
沋	eiku
滽	eilb
漮	eile
洲	eill
蚤	eilmi
溏	eilr
泳	eine
澬	eioc
涘	eiok
瀌	eipf
治	eir
淢	eirm
澸	eirp
瀇	eitc
濂	eitc
渡	eite
泧	eiv
瀍	eiwg
漉	eixp
汁	ej
沛	ejb
滇	ejbc
浡	ejbd
溹	ejbf
湳	ejbj
淔	ejbm
灢	ejbv
泬	ejc
漥	ejcg
湥	ejck
涳	ejcm
溛	ejco
溶	ejcr
沬	ejd
浨	ejd
渤	ejds
汥	eje
瀉	ejhf
浶	ejhq
瀋	ejhw
瀻	ejic
漙	ejii
涋	ejik
潓	ejip
渽	ejir
潮	ejjb
澣	ejjj
濣	ejjj
漸	ejjl
瀚	ejjm
漧	ejjn
渚	ejka
涍	ejkd
浤	ejki
洘	ejks
淒	ejlv
濱	ejmc
演	ejmc
滱	ejme
淙	ejmf
渲	ejmm
泞	ejmn
淀	ejmo
浣	ejmu
涴	ejnu
沱	ejp
濘	ejpn
滵	ejpu
瀗	ejqp
沽	ejr
湖	ejrb
涫	ejrr
濆	ejtc
洝	ejv
漃	ejye
滓	ejyj
汏	ek
洧	ekb
鋈	ekc
潦	ekcf
洃	ekf
漪	ekhr
汰	eki
汯	eki
渀	ekjt
淆	ekkb
浠	ekkb
漺	ekkk
洊	ekld
淹	eklu
洿	ekms
洟	ekn
氿	ekn
汍	ekni
浹	ekoo
滯	ekpb
氻	eks
泇	eksr
沖	el
泱	elbk
沈	elbu
垽	elg
澅	elgm
魙	elhui
渱	elim
灗	elim
汌	elll
沜	elll
沸	elln
漶	ellp
漊	ellv
潰	elmc
洮	elmo
濜	elmt
津	elq
湚	elvu
油	elw
洩	elwp
涄	elws
潚	elx
泲	elxh
淵	elxl
江	em
洹	emam
濡	embb
灞	embb
瀀	embe
瀖	embg
澐	embi
澪	embi
瀜	embi
渜	embk
洏	embl
灀	embu
酒	emcw
灑	emcw
汙	emd
濔	emfb
泙	emfj
汪	emg
涯	emgg
濏	emgh
源	emhf
鴻	emhf
瀝	emhm
溍	emia
洷	emig
汗	emj
澉	emjk
活	emjr
汙	emjs
添	emkp
浭	emlk
洲	emll
沔	emls
澒	emmc
沶	emmf
沄	emmi
灑	emmp
浯	emmr
污	emms
沅	emmu
汀	emn
洌	emnn
河	emnr
瀦	emoa
沰	emr
滆	emrb
滒	emrr
浢	emrt
湢	emrw
涿	emso
汧	emt
濿	emtb
潛	emua
灊	emub
漘	emvb
溼	emvg
溽	emvi
涇	emvm
沍	emvm
溧	emwd
漂	emwf
湮	emwg
湹	emwg
潭	emwj
湎	emwl
漹	emyf
潒	enao
浼	enau
渙	enbk
澥	enbq
湧	enbs
澹	encr
染	end
沒	ene
潏	enhb
汲	enhe
淊	enhx
汐	eni
泓	eni
涌	enib
漒	enii
沀	enin
洺	enir
汛	enj
涎	enkm
湕	enkq
瀡	enlb
濻	enlc
滁	enld
泐	enls
瀰	enmb
溺	enmm
洈	enmu
澦	ennc
湑	enob
潑	enoe
湀	enok
澄	enot
滐	enqd
瀺	enri
渳	ensj
漲	ensv
漁	enwf
漡	eoah
汭	eob
盜	eobt
泭	eodi
漵	eodk
淮	eog
潗	eogd
潐	eogf
沴	eohh
泠	eoii
洑	eoik
瀸	eoim
淰	eoip
滄	eoir
汻	eoj
瀿	eokf
滫	eolb
滌	eold
浟	eolk
澮	eoma
淪	eomb
瀹	eomb
涂	eomd
汽	eomn
渝	eomn
澰	eomo
洽	eomr
涻	eomr
渝	eomv
汔	eon
滊	eond
溣	eoob
瀲	eook
沎	eop
潪	eora
潝	eorm
渰	eort
洢	eosk
潕	eotf
濮	eoto
海	eowy
沁	ep
洵	epa
池	epd
柒	epd
淗	epfd
泌	eph
沕	ephh
淴	ephp
湉	ephr
汋	epi
浺	epl
淘	epou
沘	epp
湝	eppa
泃	epr
泡	epru
沏	epsh
泄	ept
渫	eptd
沌	epu
洶	epuk
渹	epyr
堻	eqg
潔	eqhf
浙	eqhl
湱	eqjr
湷	eqka
溱	eqkd
溙	eqke
湊	eqkk
清	eqmb
漬	eqmc
湁	eqor
呇	er
浥	erau
涓	erb
溳	erbc
浧	erhg
況	erhu
濈	erji
潞	ermr
惉	erp
湣	erpa
澡	errd
潬	errj
湒	ersj
汜	eru
潠	eruc
洖	ervk
泯	ervp
澠	erxu
浞	eryo
涮	esbn
澱	esce
渠	esd
灟	esei
沼	eshr
浘	eshu
澀	esim
涊	esip
濫	esit
洱	esj
潳	esja
灄	esjj
涺	esjr
涒	eskr
洍	esll
漏	esmb
瀷	esmc
浸	esme
濯	esmg
洭	esmg
渥	esmg
漻	esmh
潯	esmi
濢	esmj
泀	esmr
濫	esmt
潺	esnd
匯	esog
泥	esp
溤	esqf
澼	esrj
漚	esrr
洰	ess
氾	esu
淈	esuu
灠	eswu
漠	etak
灡	etaw
淟	etbc
湔	etbn
濛	etbo
洪	etc
潽	etca
澲	etcd
濝	etcf
澌	etcl
溢	etct
港	etcu
漾	etge
溔	etgf
濧	etgi
渼	etgk
濭	etgt
瀳	etif
漭	etit
浂	etk
渃	etkr
滿	etlb
潢	etlc
渶	etlk
漢	etlo
瀟	etlx
泔	etm
淇	etmc
澕	etmj
渮	etmr
湛	etmv
濩	etoe
灘	etog
瀁	etov
濍	etpp
洋	etq
溠	etqm
灌	etrg
灆	etst
洴	ett
汫	ett
溝	ettb
湴	ettc
灩	ettu
溯	etub
滋	etvi
濨	etvp
浀	etw
渵	etw
漕	etwa
澫	etwb
瀎	etwi
澧	etwt
濃	etwv
溓	etxc
淽	etym
淓	etys
汕	eu
漰	eubb
鎏	euc
鍌	euc
澂	eugk
灃	eujt
洶	euk
湍	eumb
湠	eumf
滍	eumi
溰	eumt
涵	eune
漼	euog
涔	euon
灩	eutt
灩	eutu
泏	euu
溦	euuk
汝	ev
灤	evfd
濰	evfg
灣	evfn
濼	evid
泑	evis
淥	evne
洳	evr
灉	evug
漅	evvd
淄	evvw
沺	ew
渭	ewb
泗	ewc
淉	ewd
涃	ewd
潿	ewdq
溿	ewfq
浬	ewg
潶	ewgf
漍	ewim
涸	ewjr
洇	ewk
湡	ewlb
濁	ewli
澤	ewlj
瀱	ewln
潀	ewlo
澴	ewlv
淠	ewml
溷	ewmo
渨	ewmv
歠	ewno
泅	ewo
溫	ewot
洄	ewr
潩	ewtc
滭	ewtj
漯	ewvf
灅	ewwg
淖	eyaj
渧	eybb
濄	eybb
湞	eybc
灕	eybg
澈	eybk
瀧	eybp
滂	eybs
濬	eybu
滴	eycb
洨	eyck
滾	eycv
潡	eydk
漷	eydl
瀙	eydu
澯	eyed
瀣	eyem
淑	eyfe
注	eyg
瀕	eyhc
滻	eyhm
沆	eyhn
汸	eyhs
淯	eyib
流	eyiu
灨	eyjc
漣	eyjj
汶	eyk
滻	eykm
沛	eylb
瀢	eylc
涉	eylh
沚	eylm
濊	eymh
泚	eymp
瀛	eync
瀛	eynv
淬	eyoj
液	eyok
滹	eypd
澞	eypk
淲	eypn
澽	eypo
濾	eypp
瀘	eypt
淲	eypu
沾	eyr
滈	eyrb
淳	eyrd
涼	eyrf
滸	eyrj
渟	eyrn
濠	eyro
湸	eyru
瀼	eyrv
游	eysd
湤	eysd
漩	eyso
淤	eysy
泣	eyt
湆	eyta
湇	eytb
潼	eytg
漳	eytj
澺	eytp
涪	eytr
漓	eyub
滮	eyuh
汒	eyv
澭	eyvg
泫	eyvi
滀	eyvw
凜	eywd
滷	eywi
澶	eywm
瀤	eywv
滖	eywv
濟	eyx
汴	eyy
火	f
焨	fab
熅	fabt
熀	fafu
煋	fahm
焺	faht
煝	fahu
炟	fam
煬	famh
焊	famj
燘	fank
燜	fanp
爛	fanw
爓	fanx
焜	fapp
爆	fate
燁	fatj
熳	fawe
煜	fayt
肖	fb
熐	fbac
燰	fbbe
炯	fbcr
鶺	fbhaf
煇	fbjj
燃	fbkf
削	fbln
煖	fbme
烔	fbmr
烰	fbnd
敝	fbok
敞	fbok
尚	fbr
炯	fbr
賞	fbrbc
棠	fbrd
堂	fbrg
党	fbrhu
常	fbrlb
牚	fbrmh
瓽	fbrmn
嘗	fbrpa
掌	fbrq
當	fbrw
黨	fbrwf
裳	fbryv
爝	fbwi
烿	fbyh
脊	fcb
炂	fci
焍	fcnh
焀	fcor
米	fd
炑	fd
糧	fdamg
粑	fdau
粗	fdbm
粡	fdbmr
粣	fdbt
粯	fdbuu
粉	fdcsh
爩	fddh
籿	fddi
粖	fddj
糔	fdeii
粕	fdha
粄	fdhe
粁	fdhj
糌	fdhoa
粍	fdhqu
糗	fdhuk
粺	fdhwj
糐	fdibi
粧	fdig
糝	fdiih
糠	fdile
糖	fdilr
麊	fdixp
籵	fdj
粀	fdjk
粽	fdjmf
糊	fdjrb
炔	fdk
粨	fdma
糯	fdmbb
粞	fdmcw
粳	fdmlk
煒	fdmq
糲	fdmtb
籽	fdnd
粈	fdng
糅	fdnhd
糨	fdnii
籸	fdnj
粌	fdnl
糑	fdnmm
糈	fdnob
敉	fdok
籺	fdon
粅	fdphh
精	fdqmb
糮	fdsit
粻	fdsmv
米	fdso
粔	fdss
糢	fdtak
糷	fdtaw
糋	fdtbn
糕	fdtgf
糒	fdthb
糟	fdtwa
籹	fdv
粿	fdwd
煉	fdwf
粴	fdwg
糰	fdwji
糬	fdwla
糞	fdwtc
烞	fdy
糙	fdyhr
料	fdyj
粹	fdyoj
粘	fdyr
粒	fdyt
炎	ff
膋	ffbb
覮	ffbbu
鎣	ffbc
榮	ffbd
滎	ffbe
爣	ffbf
熒	ffbf
塋	ffbg
鶯	ffbhf
犖	ffbhq
勞	ffbks
螢	ffbli
禜	ffbmf
瑩	ffbmi
甇	ffbmn
醟	ffbmw
煢	ffbnj
罃	ffbou
營	ffbrr
覢	ffbuu
嫈	ffbv
縈	ffbvf
謍	ffbyr
褮	ffbyv
燐	ffdq
燮	ffe
焱	fff
燊	fffd
爃	fffd
燚	ffff
炒	ffh
飆	ffhni
剡	ffln
顃	ffmb
纇	ffmbc
郯	ffnl
欻	ffno
敥	ffye
虩	ffypu
煔	ffyr
灶	fg
烓	fgg
燒	fggu
熆	fgit
燽	fgni
熹	fgrr
少	fh
煌	fhag
燠	fhbk
烅	fhbt
省	fhbu
煍	fhdf
熪	fhdn
燔	fhdw
烽	fhej
烙	fher
炵	fhey
燬	fhge
燻	fhgf
烍	fhgu
煄	fhjg
燆	fhkb
劣	fhks
焮	fhlo
燬	fhme
炘	fhml
烆	fhon
爐	fhs
煸	fhsb
煽	fhsm
熩	fhsu
熄	fhup
熜	fhwp
烺	fiav
焌	fice
煘	fihr
烳	fijb
蠽	filii
煻	filr
爊	fipf
烒	fipm
爌	fitc
熝	fixp
焢	fjcm
熔	fjcr
烢	fjhp
烤	fjks
烷	fjmu
焥	fjnu
尖	fk
烠	fkb
瞥	fkbu
燎	fkcf
煃	fkgg
鷩	fkhaf
氅	fkhqu
獘	fkik
烯	fkkb
幣	fklb
蟞	fklmi
類	fkmbc
斃	fkmnp
彆	fkn
鱉	fknwf
憋	fkp
鄨	fkrau
鱉	fkrxu
蹩	fkryo
熁	fksb
燲	fksc
弊	fkt
嫳	fkv
炴	flbk
爞	flii
熡	fllv
烑	flmo
燼	flmt
熽	flx
灴	fm
烜	fmam
燸	fmbb
煩	fmbc
爧	fmbo
焐	fmmr
燈	fmn
炳	fmob
烼	fmso
光	fmu
熸	fmua
烴	fmvm
熛	fmwf
煙	fmwg
燂	fmwj
炡	fmym
煥	fnbk
炄	fng
燏	fnhb
煣	fnhd
焰	fnhx
烶	fnkg
烻	fnkm
煡	fnkq
炊	fno
燈	fnot
揱	fnq
尐	fo
雀	fog
燋	fogf
炩	foii
熗	foir
焓	foir
燴	foma
爚	fomb
烇	fomg
烚	fomr
熂	fond
灺	fopd
炸	fos
烸	fowy
灺	fpd
灼	fpi
灼	fpm
炮	fpru
煠	fptd
炖	fpu
半	fq
眷	fqbu
韏	fqdmq
叛	fqhe
牶	fqhq
帣	fqlb
判	fqln
頖	fqmbc
豢	fqmso
甐	fqmvn
弮	fqn
觠	fqnbg
鄰	fqnl
拳	fqq
券	fqsh
翷	fqsmm
卷	fqsu
亃	fqu
絭	fqvif
粼	fqvv
齤	fqymu
焆	frb
熉	frbc
炾	frhu
燥	frrd
燀	frrj
煰	frrr
煆	frse
熞	fseg
燭	fsei
灱	fsh
炤	fshr
焰	fshx
爁	fsit
熠	fsma
燿	fsmg
燖	fsmi
熤	fsmt
熰	fsrr
炬	fss
焗	fssr
爦	fswu
焟	fta
烘	ftc
烡	ftc
煪	ftcw
燨	ftgi
爔	ftgs
熿	ftlc
煂	ftlj
煐	ftlk
熯	ftlo
煤	ftmd
燁	ftmj
煁	ftmv
烊	ftq
爟	ftrg
燤	ftwb
燇	ftwi
輝	fubjj
煓	fumb
耀	fusmg
爍	fvid
煟	fwb
爅	fwgg
煙	fwk
燭	fwli
燡	fwlj
顲	fwmbc
煨	fwmv
熅	fwot
熼	fwtc
熚	fwtj
焯	fyaj
熵	fycb
燉	fydk
燦	fyed
炷	fyg
炕	fyhn
熾	fyia
炓	fyj
炆	fyk
熥	fynb
焠	fyoj
焲	fyok
爐	fypt
熇	fyrb
焞	fyrd
爙	fyrv
燧	fyto
燱	fytp
焙	fytr
炫	fyvi
烗	fyvo
土	g
塭	gabt
塒	gagi
堳	gahu
坦	gam
場	gamh
罈	gami
堤	gamo
壛	ganx
埸	gaph
堨	gapv
塌	gasm
垠	gav
墁	gawe
冉	gb
塓	gbac
堋	gbb
堝	gbbr
堔	gbcd
埰	gbd
埒	gbdi
觳	gbhne
壺	gblm
埧	gbmc
壼	gbmm
塚	gbmo
垌	gbmr
壹	gbmt
垺	gbnd
坰	gbr
埩	gbsd
堈	gbtu
坍	gby
覿	gcbuu
皾	gcdhe
坴	gcg
赫	gcglc
夌	gche
赯	gcilr
塕	gcim
赭	gcjka
赨	gclmi
赩	gcnau
郝	gcnl
赦	gcok
赮	gcrse
鼀	gcrxu
坋	gcsh
赧	gcsle
增	gcwa
赬	gcybc
坡	gdhe
穀	gdhne
寺	gdi
埬	gdw
堜	gdwf
瞽	gebu
鏧	gec
漀	gee
鼜	geeii
鼞	gefbg
馨	gehda
鼕	gehey
毊	gehkb
鼛	gehor
鼙	gehwj
螜	gelmi
鼘	gelxl
磬	gemr
罄	geoju
愨	gep
擊	geq
聲	gesj
鼚	gesmv
謦	geymr
韾	geyta
塉	gfcb
埮	gff
鷇	gfhn
縠	gfhne
垙	gfmu
款	gfno
坢	gfq
埢	gfqu
圭	gg
堎	ggce
封	ggdi
燅	ggff
垚	ggg
堯	gggu
墝	gggu
鵱	gghaf
埶	ggkni
刲	ggln
壔	ggni
邽	ggnl
墻	ggow
恚	ggp
奊	ggvk
卦	ggy
堭	ghag
墺	ghbk
墦	ghdw
阪	ghe
垀	ghfd
壎	ghgf
塯	ghhw
堹	ghjg
埵	ghjm
圻	ghml
垢	ghmr
甏	ghmvn
坼	ghmy
垛	ghnd
堸	ghni
坻	ghpm
塢	ghrf
埠	ghrj
墽	ghsk
塊	ghui
坁	ghvp
埤	ghwj
堄	ghxu
去	gi
朅	giapv
埌	giav
盍	gibt
贄	gibuc
槷	gid
熱	gif
墊	gig
幫	gihab
鷙	gihaf
犎	gihq
堿	gihr
城	gihs
墋	giih
埔	gijb
勢	giks
劫	giks
墉	gilb
蟄	gilmi
劫	giln
塘	gilr
邿	ginl
垿	ginn
埃	giok
慹	gip
摯	giq
域	girm
鼁	girxu
卻	gisl
翿	gismm
騺	gisqf
壙	gitc
鞤	gitlj
縶	givif
塶	gixp
謺	giymr
填	gjbc
埴	gjbm
塎	gjcr
轂	gjhne
垞	gjhp
瓡	gjhvo
塼	gjii
墘	gjjn
堵	gjka
執	gjkni
垸	gjmu
坨	gjp
報	gjsle
墳	gjtc
垵	gjv
盩	gkbt
贅	gkbuc
鏊	gkc
熬	gkf
獒	gkik
塽	gkkk
螫	gklm
螯	gklmi
堶	gkmb
埼	gkmr
垮	gkms
鰲	gknwf
墆	gkpb
摮	gkq
鼇	gkrxu
聱	gksj
驁	gksqf
謷	gkymr
坱	glbk
埭	gle
圳	glll
坲	glln
塿	gllv
垗	glmo
赤	glnc
垏	glq
坤	glwl
垣	gmam
壩	gmbb
堧	gmbb
堧	gmbk
鋆	gmc
圩	gmd
坏	gmf
坪	gmfj
坯	gmfm
堐	gmgg
壢	gmhm
垤	gmig
埂	gmlk
埡	gmlm
圬	gmms
圢	gmn
坷	gmnr
塥	gmrb
堛	gmrw
壩	gmwb
塛	gmwd
墂	gmwf
堙	gmwg
堍	gnai
埆	gnbg
圾	gnhe
彀	gnhn
殼	gnhne
埳	gnhx
埇	gnib
埏	gnkm
燾	gnmf
壽	gnmi
垝	gnmu
坎	gno
婿	gnob
墱	gnot
場	goah
趕	goamj
趧	goamo
趄	gobm
趛	goc
赽	godk
趙	gofb
趟	gofbr
赻	gofh
堆	gog
趬	goggu
趌	gogr
趎	gohjd
趏	gohjr
趫	gohkb
趓	gohnd
豰	gohne
趲	gohuc
坽	goii
垘	goik
趑	goimo
坅	goin
趑	goior
越	goiv
赲	goks
趒	golmo
趀	golxh
坵	gom
赶	gomj
趑	gommo
堬	gomn
趔	gomnn
垥	gomr
圪	gon
趍	gonin
堠	gonk
超	gonr
趡	goog
趭	googf
趁	goohh
趖	gooog
趜	gopfd
赹	gopmm
趨	gopuu
趮	gorrd
起	goru
超	goshr
趣	gosje
趯	gosmg
趐	gosmm
起	gosu
趥	gotcw
趪	gotlc
赸	gou
趉	gouu
赳	govl
嗇	gowr
赴	goy
趠	goyaj
志	gp
覟	gpbuu
地	gpd
圴	gpi
均	gpim
均	gpmm
堩	gpmm
階	gppa
堞	gptd
坉	gpu
垹	gqjl
埲	gqkq
埥	gqmb
吉	gr
塤	grbc
臺	grbg
囍	grgrr
鴶	grhaf
埕	grhg
嗀	grhne
袁	grhv
劼	grks
頡	grmbc
嚭	grmfr
歖	grno
欯	grno
墠	grrj
壧	grrk
堮	grrs
喪	grrv
壴	grt
熹	grtf
喜	grtr
嘉	grtr
圯	gru
敼	grye
堰	gsav
墀	gseq
壏	gsit
壣	gsjt
埽	gsmb
埐	gsme
敖	gsok
坭	gsp
圮	gsu
堀	gsuu
塻	gtak
墣	gtco
塨	gtcp
尌	gtdi
墡	gtgr
壒	gtgt
彭	gthhh
懿	gtiop
幸	gtj
鼓	gtje
墐	gtlm
坩	gtm
懿	gtmop
堪	gtmv
塔	gtor
垟	gtq
壾	gtss
墡	gttr
亄	gtu
墈	gtvs
墫	gtwi
圠	gu
塴	gubb
瞉	guhne
顤	gumbc
塏	gumt
墔	guog
埁	guon
翹	gusmm
坳	gvis
堁	gwd
埋	gwg
毐	gwj
堌	gwjr
堣	gwlb
賣	gwlc
墿	gwlj
堽	gwlm
塭	gwot
坶	gwyi
塝	gybs
墑	gycb
墩	gydk
墎	gydl
埱	gyfe
坑	gyhn
坊	gyhs
堉	gyib
壝	gylc
址	gylm
走	gyo
埣	gyoj
墟	gypm
壉	gypo
壚	gypt
坫	gyr
塙	gyrb
埻	gyrd
壕	gyro
壤	gyrv
垃	gyt
堷	gyta
墥	gytg
墇	gytj
垶	gytj
培	gytr
境	gytu
垓	gyvo
壈	gywd
壇	gywm
壞	gywv
竹	h
丿	h
白	ha
馧	haabt
皭	habwi
泉	hae
灥	haehe
皛	hahaa
馫	hahaa
皞	hahaj
皤	hahdw
皈	hahe
皓	hahgr
皒	hahqi
皦	hahsk
魄	hahui
節	hail
皫	haipf
皁	haj
馞	hajbd
皖	hajmu
皋	hakj
馣	haklu
帛	halb
馡	halmy
笪	ham
皇	hamg
筸	hamj
簡	hana
簢	hank
籣	hanw
馥	haoae
皊	haoii
皂	hap
馝	haph
的	hapi
馜	hasp
皏	hatt
馦	hatxc
笆	hau
癿	hau
皚	haumt
皪	havid
簋	havt
馧	hawot
皎	hayck
梟	hayd
鳥	hayf
皉	haymp
皜	hayrb
島	hayu
裊	hayv
舋	hbbm
覺	hbbuu
爨	hbddf
澩	hbe
燢	hbf
爂	hbf
籐	hbfe
壆	hbg
鶣	hbhaf
鷮	hbhaf
鷽	hbhaf
鵳	hbhaf
嚳	hbhgr
綿	hbhvf
奧	hbk
筋	hbks
制	hbln
籲	hbmbc
顅	hbmbc
釁	hbmch
璺	hbmgi
筒	hbmr
礐	hbmr
箸	hbms
甂	hbmvn
觷	hbnbg
學	hbnd
鄅	hbnl
鱟	hbnwf
敿	hbok
甪	hbq
向	hbr
箏	hbsd
箙	hbse
翩	hbsmm
血	hbt
黌	hbtlc
自	hbu
嶨	hbu
纂	hbuf
篎	hbuh
篡	hbui
算	hbut
筧	hbuu
篹	hbuu
舟	hbyi
鸒	hchaf
籦	hchg
籛	hcii
轝	hcjwj
劉	hcln
劗	hcln
釁	hcmch
礜	hcmr
酇	hcnl
鄮	hcnl
歟	hcno
舉	hcq
嬃	hcv
籙	hcve
譽	hcymr
禾	hd
香	hda
穊	hdaiu
稈	hdamj
策	hdb
稱	hdbgb
稠	hdbgr
稻	hdbhx
租	hdbm
穩	hdbmp
稃	hdbnd
穄	hdbof
稠	hdbqr
盉	hdbt
箱	hdbu
穱	hdbwi
稊	hdcnh
稅	hdcru
秎	hdcsh
箖	hdd
秣	hddj
稦	hddmq
秋	hdf
稍	hdfb
秒	hdfh
稜	hdgce
稑	hdgcg
穘	hdggu
穡	hdgow
秸	hdgr
鴸	hdhaf
鷍	hdhaf
穆	hdhah
秝	hdhd
種	hdhjg
穚	hdhkb
毇	hdhne
秅	hdhp
秪	hdhpm
秩	hdhqo
秏	hdhqu
稨	hdhsb
禿	hdhu
秖	hdhvp
稗	hdhwj
私	hdi
稂	hdiav
稄	hdice
穇	hdiih
秫	hdijc
穮	hdipf
秮	hdir
稢	hdirm
穬	hditc
稽	hdiua
嵇	hdiuu
稹	hdjbc
稙	hdjbm
秺	hdjhp
穗	hdjip
稼	hdjmo
稀	hdkkb
秉	hdl
種	hdl
秧	hdlbk
籟	hdlc
利	hdln
剁	hdln
簌	hdlo
乘	hdlp
釉	hdlw
秞	hdlw
秭	hdlxh
笨	hdm
秤	hdmfj
秠	hdmfm
秷	hdmig
稫	hdmrw
甈	hdmvn
季	hdnd
秀	hdnhs
移	hdnin
邾	hdnl
鄡	hdnl
臲	hdnmu
稰	hdnob
穭	hdnwa
黍	hdoe
稚	hdog
穛	hdogf
稔	hdoip
稐	hdomb
稌	hdomd
箂	hdoo
悉	hdp
秘	hdph
秕	hdpp
積	hdqmc
和	hdr
程	hdrhg
程	hdrmg
穋	hdsmh
秜	hdsp
秬	hdss
稓	hdta
穔	hdtlc
稘	hdtmc
穫	hdtoe
穠	hdtwv
秈	hdu
稯	hduce
委	hdv
穖	hdvii
番	hdw
稷	hdwce
稞	hdwd
稛	hdwhd
稒	hdwjr
釋	hdwlj
科	hdyj
穢	hdymh
稿	hdyrb
稕	hdyrd
穰	hdyrv
穜	hdytg
穟	hdyto
穧	hdyx
反	he
夊	he
篞	heag
簜	heah
篞	heam
盤	hebt
槃	hed
垼	heg
箔	heha
籓	hehw
簿	heii
箈	heir
幋	helb
磐	hemr
鄋	henl
慇	hep
搫	heq
夆	heqj
各	her
笵	hesu
篊	hetc
鞶	hetlj
媻	hev
縏	hevif
冬	hey
褩	heyhv
黏	heyr
黐	heyub
鵿	hfaht
鸔	hfate
筲	hfb
箾	hfbn
簹	hfbw
乎	hfd
釆	hfd
鴃	hfdk
簩	hffs
鶖	hfhaf
鳧	hfhn
鶳	hfhrb
箵	hfhu
鷈	hfhyu
鵔	hfice
鴥	hfjc
鴕	hfjp
勳	hfks
蝵	hflmi
甃	hfmvn
鳦	hfn
鄔	hfnl
歍	hfno
鵻	hfog
鵌	hfomd
愁	hfp
揫	hfq
鷌	hfsqf
鸃	hftgi
鶀	hftmc
媝	hfv
鷻	hfydk
壬	hg
簭	hgcr
等	hgdi
濌	hgea
熏	hgf
皝	hgfmu
筀	hgg
毀	hghne
先	hghu
丟	hgi
篕	hgit
動	hgks
顧	hgmbc
籌	hgni
筠	hgpm
告	hgr
籉	hgrg
靠	hgrly
篁	hhag
卿	hhail
貿	hhbuc
射	hhdi
筣	hhdn
簃	hhdn
躺	hhfbr
軂	hhffs
筶	hhgr
筅	hhgu
彡	hhh
鵹	hhhaf
躲	hhhnd
辵	hhho
犁	hhhq
箠	hhjm
軉	hhjmc
筈	hhjr
笑	hhk
簥	hhkb
擔	hhlbu
笊	hhlo
須	hhmbc
躬	hhn
躲	hhnsd
鯬	hhnwf
黎	hhoe
篽	hhol
簁	hhoo
笙	hhqm
篩	hhrb
躽	hhsav
篇	hhsb
卯	hhsl
贕	hhslc
孵	hhsld
毈	hhsle
卵	hhsli
軀	hhsrr
籫	hhuc
留	hhw
黧	hhwgf
箄	hhwj
篦	hhwp
籅	hhxc
篪	hhyu
么	hi
筤	hiav
簠	hibt
魍	hibtv
魈	hifb
鵝	hihaf
鬿	hihml
犩	hihq
箴	hihr
箋	hii
篸	hiih
魃	hiikk
魊	hiirm
魆	hiiv
魅	hijd
鬾	hije
魎	himlb
魒	himwf
乏	hino
魋	hiog
笞	hir
笲	hit
簾	hitc
魌	hitmc
魕	hivii
簏	hixp
魁	hiyj
魖	hiypm
魑	hiyub
千	hj
質	hjbc
盾	hjbu
箜	hjcm
朱	hjd
鵯	hjhaf
段	hjhne
臿	hjhx
篿	hjii
簙	hjii
簳	hjjj
簐	hjjo
範	hjju
箸	hjka
箑	hjlo
乖	hjlp
顊	hjmbc
簆	hjmk
筦	hjmu
郫	hjnl
舌	hjr
管	hjrr
翱	hjsmm
垂	hjtm
重	hjwg
夭	hk
昋	hka
簝	hkcf
棨	hkd
鸄	hkhaf
笅	hkk
蚕	hklmi
肇	hklq
筴	hkoo
忝	hkp
懲	hkp
吞	hkr
啟	hkr
喬	hkrbr
竻	hks
笳	hksr
嶴	hku
綮	hkvif
譥	hkymr
齃	hlapv
禹	hlbi
質	hlbuc
齉	hljbv
鼽	hlkn
齂	hlle
簰	hllj
劓	hlln
笰	hlln
簍	hllv
頎	hlmbc
簣	hlmc
鼾	hlmj
禦	hlmmf
筄	hlmo
齀	hlmvn
欣	hlno
爪	hlo
齁	hlpr
筆	hlq
齈	hltwv
籔	hlvk
齆	hlvvu
笛	hlw
斶	hlwli
簫	hlx
笫	hlxh
齇	hlypm
笁	hm
篢	hmbc
籗	hmbg
眚	hmbu
竽	hmd
箌	hmgn
籈	hmgn
筭	hmgt
鴟	hmhaf
鷎	hmhaf
斲	hmhml
筑	hmhn
毀	hmhne
甡	hmhqm
竿	hmj
笄	hmjj
斤	hml
竺	hmm
笎	hmmu
甀	hmmvn
築	hmnd
郵	hmnl
邸	hmnl
笻	hmnl
篫	hmnq
笴	hmnr
筮	hmoo
后	hmr
筇	hmsl
歸	hmsmb
卮	hmsu
笄	hmt
簪	hmua
篥	hmwd
篻	hmwf
簟	hmwj
甥	hmwks
斥	hmy
几	hn
颺	hnamh
颶	hnbmc
簷	hncr
朵	hnd
梨	hnd
箛	hndo
殳	hne
篜	hnef
颾	hneii
飆	hnfff
凰	hnhag
笈	hnhe
颩	hnhhh
飀	hnhhw
颳	hnhjr
風	hnhli
犁	hnhq
颼	hnhxe
凡	hni
筩	hnib
颱	hnir
飉	hnkcf
筳	hnkg
筵	hnkm
篨	hnld
第	hnlh
鳳	hnmaf
飋	hnmgh
颳	hnmjr
風	hnmli
篛	hnmm
夙	hnmni
颲	hnmnn
颬	hnmvh
簦	hnot
愆	hnp
颮	hnpru
掣	hnq
躗	hnryo
飂	hnsmh
颸	hnwp
製	hnyhv
讆	hnymr
颭	hnyr
八	ho
彳	ho
昝	hoa
得	hoami
徥	hoamo
爬	hoau
忁	hoaue
很	hoav
籲	hobc
篧	hobg
衢	hobgn
徟	hobgr
徂	hobm
徭	hobou
衕	hobrn
徯	hobvk
彸	hoci
銜	hocmn
衛	hodbn
彼	hodhe
符	hodi
徫	hodmq
徠	hodoo
衛	hodqn
衍	hoemn
熧	hof
徶	hofbk
徜	hofbr
待	hogdi
街	hoggn
徒	hogyo
鴔	hohaf
鴩	hohaf
徨	hohag
衝	hohgn
循	hohju
役	hohne
彽	hohpm
瓞	hohqo
遍	hohsb
徼	hohsk
筏	hoi
術	hoicn
笭	hoii
籤	hoim
笒	hoin
徖	hojmf
衚	hojrn
德	hojwp
徛	hokmr
劮	hoks
篠	hold
瓥	holii
筱	holk
彿	holln
徘	holmy
律	holq
籥	homb
徆	homcw
筡	homd
筌	homg
衎	homjn
箯	homk
行	hommn
簽	homo
答	homr
衙	homrn
徑	homvm
征	homym
彶	honhe
篌	honk
衡	honkn
復	hooae
彾	hooii
徻	hooma
徐	hoomd
御	hooml
從	hoooo
筰	hoos
慫	hop
徇	hopa
彴	hopi
瓝	hopi
瓟	hopru
篟	hoqb
咎	hor
徦	horse
笮	hos
徲	hoseq
聳	hosj
衖	hotcn
徉	hotq
徽	houfk
黴	houfk
鰴	houfk
徵	hougk
徾	hourk
微	houuk
後	hovie
徊	howr
徹	hoybk
徿	hoybp
徬	hoybs
往	hoyg
彷	hoyhs
衒	hoyin
斞	hoyj
徙	hoylo
忀	hoyrv
乇	hp
昏	hpa
筍	hpa
筷	hpdk
鵖	hphaf
笏	hphh
剩	hpln
氐	hpm
笉	hpmm
鄎	hpnl
笓	hpp
笱	hpr
笣	hpru
印	hpsl
篘	hpuu
牛	hq
犦	hqate
犋	hqbmc
犅	hqbtu
看	hqbu
犑	hqbuk
籍	hqda
犈	hqfqu
牡	hqg
特	hqgdi
犢	hqgwc
犐	hqhdj
牿	hqhgr
犞	hqhkb
牴	hqhpm
牪	hqhq
牲	hqhqm
籀	hqhw
我	hqi
犥	hqipf
牻	hqiuh
犆	hqjbm
篲	hqjm
牸	hqjnd
犗	hqjqr
牯	hqjr
犄	hqkmr
牞	hqks
牰	hqlw
牬	hqlxh
生	hqm
箐	hqmb
簀	hqmc
牾	hqmmr
拜	hqmqj
犡	hqmtb
牼	hqmvm
觕	hqnbg
犍	hqnkq
邦	hqnl
失	hqo
牧	hqok
牷	hqomg
牝	hqp
牠	hqpd
物	hqphh
犓	hqpuu
筘	hqr
犌	hqrse
箍	hqsb
牣	hqshi
簎	hqta
簼	hqtb
犪	hqtce
犧	hqtgs
犕	hqthb
箝	hqtm
毛	hqu
犣	hqvvv
籜	hqwj
犤	hqwlp
牳	hqwyi
犒	hqyrb
犉	hqyrd
犝	hqytg
篔	hrbc
舕	hrff
垕	hrg
舑	hrgb
鵠	hrhaf
鴰	hrhaf
鵅	hrhaf
鴭	hrhaf
舔	hrhkp
舐	hrhpm
筥	hrhr
舐	hrhvp
阜	hrj
勂	hrks
帥	hrlb
蛗	hrlmi
刮	hrln
劄	hrln
頧	hrmbc
舔	hrmkp
師	hrmlb
簬	hrmr
郜	hrnl
郈	hrnl
雒	hrog
啟	hrok
簞	hrrj
甜	hrtm
峊	hru
簨	hruc
笢	hrvp
烏	hryf
戶	hs
勹	hs
肩	hsb
扃	hsbr
扁	hsbt
勳	hsf
扊	hsff
所	hshml
殷	hshne
笤	hshr
戾	hsik
籃	hsit
筍	hsk
篋	hsko
扉	hslmy
篚	hsly
帚	hsmb
筐	hsmg
籊	hsmg
笥	hsmr
籃	hsmt
雇	hsog
篤	hsqf
笸	hsr
扈	hsrau
戺	hsru
扇	hssmm
房	hsyhs
扆	hsyhv
戽	hsyj
扂	hsyr
升	ht
箭	htbn
簸	htce
簊	htcg
鷑	hthaf
眾	hthho
箬	htkr
簧	htlc
箕	htmc
衃	htmf
衄	htng
憩	htp
衈	htsj
卹	htsl
篝	httb
衊	httwi
贊	hubuc
臬	hud
皋	huej
毯	huff
鶂	huhaf
鶞	huhaf
鵚	huhaf
毨	huhgu
兟	huhgu
毳	huhuu
鬼	hui
毧	huij
毬	huije
臭	huik
瞂	huikk
穨	hulmc
頹	humbc
毢	humcw
毽	hunkq
郳	hunl
郋	hunl
歋	huno
氌	hunwa
臮	huooo
息	hup
憩	hup
氁	hutak
氆	hutca
氆	hutma
鼻	huwml
毸	huwp
鼻	huwt
氈	huyr
罪	huytj
毰	huytr
鼲	hvbjj
鼰	hvbuc
鼳	hvbuk
覛	hvbuu
覣	hvbuu
鼷	hvbvk
鼢	hvcsh
笯	hve
箹	hvfi
鼭	hvgdi
鼨	hvhey
鼪	hvhqm
兜	hvhu
魏	hvhui
鼶	hvhyu
系	hvif
鼣	hvik
鼥	hvikk
籪	hvil
瓜	hvio
鼵	hvjck
鼬	hvlw
鼯	hvmmr
鼫	hvmr
瓾	hvmvn
鼮	hvnkg
篆	hvno
氏	hvp
鼩	hvpr
鼱	hvqmb
筎	hvr
鼴	hvsav
卬	hvsl
鼸	hvtxc
鼤	hvyk
笝	hwe
睾	hwgtj
鷭	hwhaf
鶹	hwhaf
箘	hwhd
卑	hwhj
簂	hwim
箇	hwjr
囟	hwk
囪	hwkk
勫	hwks
笚	hwl
籮	hwlg
篾	hwli
箅	hwml
粵	hwmvs
囪	hwni
鄱	hwnl
飛	hwnoo
匆	hwp
翻	hwsmm
篳	hwtj
臼	hx
興	hxbc
盥	hxbt
身	hxh
兒	hxhu
輿	hxjc
帠	hxlb
叟	hxle
歃	hxno
臾	hxo
舁	hxt
鼠	hxvyv
舅	hxwks
與	hxyc
舄	hxyf
昝	hya
艒	hyabu
舥	hyau
簻	hybb
籬	hybg
艀	hybnd
籠	hybp
篣	hybs
筊	hyck
船	hycr
艄	hyfb
艡	hyfbw
舶	hyha
鵃	hyhaf
艎	hyhag
舨	hyhe
艂	hyhej
舽	hyheq
篷	hyhj
艞	hyhlo
簅	hyhm
笐	hyhn
般	hyhne
船	hyhnr
簉	hyhr
籩	hyhs
艑	hyhsb
艘	hyhxe
舵	hyjp
簅	hykm
舿	hykms
艜	hykpb
舯	hyl
螽	hylii
艛	hyllv
舳	hylw
舡	hym
舸	hymnr
篴	hymo
籯	hync
艋	hyndt
艇	hynkg
艬	hynri
艭	hyoge
舲	hyoii
艙	hyoir
箤	hyoj
艅	hyomd
舴	hyos
籚	hypt
艓	hyptd
虒	hypu
箎	hypu
咎	hyr
笘	hyr
篙	hyrb
篰	hyrl
籇	hyro
箷	hysd
舠	hysh
艉	hyshu
艦	hysit
簇	hysk
艦	hysmt
箊	hysy
笠	hyt
艨	hytbo
舼	hytc
艗	hytct
艤	hytgi
艏	hythu
艖	hytqm
艚	hytwa
舢	hyu
篱	hyub
艐	hyuce
笀	hyv
舺	hywl
簑	hywv
艕	hyybs
航	hyyhn
舫	hyyhs
籧	hyyo
艣	hyyps
艫	hyypt
艟	hyytg
舷	hyyvi
艩	hyyx
戈	i
、	i
廄	iaie
廄	iaiu
良	iav
禸	ib
宀	ib
廁	ibcn
廮	ibcv
尃	ibdi
塱	ibg
鵏	ibhaf
鷛	ibhaf
郙	ibnl
鄘	ibnl
能	ibpp
糜	icfd
麼	ichi
麾	ichqu
魔	ichui
黂	icjtc
靡	iclmy
磨	icmr
鄺	icnl
廞	icno
怷	icp
摩	icq
黀	icsje
麼	icvi
床	id
廂	idbu
麻	idd
糜	idfd
塺	idg
穈	idhd
麼	idhi
犘	idhq
麾	idhqu
魔	idhui
黂	idjtc
靡	idlmy
磨	idmr
庲	idoo
摩	idq
黀	idsje
麼	idvi
縻	idvif
冰	ie
昶	iea
盚	iebt
皴	iedhe
剫	ieln
救	ieok
裘	ieyhv
禓	ifamh
禔	ifamo
禢	ifasm
禍	ifbbr
禂	ifbgr
禈	ifbjj
廠	ifbk
祖	ifbm
禐	ifbme
視	ifbuu
禕	ifdmq
禷	iffkc
社	ifg
祛	ifgi
禱	ifgni
禧	ifgrr
鷓	ifhaf
祰	ifhgr
祩	ifhjd
祅	ifhk
祈	ifhml
祋	ifhne
祗	ifhpm
祑	ifhqo
禶	ifhuc
祇	ifhvp
禠	ifhyu
祓	ifikk
祴	ifit
禛	ifjbc
祜	ifjr
祐	ifkr
祌	ifl
祧	iflmo
神	iflwl
顣	ifmbc
禰	ifmfb
祆	ifmk
祳	ifmmv
祏	ifmr
福	ifmrw
禲	ifmtb
禋	ifmwg
禫	ifmwj
礽	ifnhs
祁	ifnl
鄬	ifnl
祪	ifnmu
祔	ifodi
祣	ifohv
祄	ifoll
禬	ifoma
禴	ifomb
祫	ifomr
祚	ifos
憑	ifp
慼	ifp
祂	ifpd
祕	ifph
礿	ifpi
祹	ifpou
禊	ifqhk
祝	ifrhu
禪	ifrrj
祀	ifru
蹙	ifryo
祒	ifshr
祲	ifsme
祤	ifsmm
祠	ifsmr
禡	ifsqf
祀	ifsu
禚	iftgf
祺	iftmc
禖	iftmd
祥	iftq
禮	iftwt
禨	ifvii
祿	ifvne
禒	ifvno
祼	ifwd
禤	ifwlm
禗	ifwp
禘	ifybb
禎	ifybc
祊	ifyhs
祉	ifylm
祽	ifyoj
禳	ifyrv
禭	ifyto
庄	ig
庱	igce
庤	igdi
廅	igit
廧	igow
廒	igsk
廚	igti
戊	ih
毿	ihhqu
廇	ihhw
戍	ihi
螷	ihji
蠯	ihji
剼	ihln
戌	ihm
庍	ihml
咸	ihmr
威	ihmv
廄	ihpe
底	ihpm
牟	ihq
成	ihs
允	ihu
廆	ihui
庳	ihwj
廋	ihxe
庾	ihxo
戚	ihymf
戔	ii
朗	iib
盞	iibt
絫	iiif
參	iiih
廊	iiil
剷	iiln
剆	iiln
疒	iim
郎	iinl
欴	iino
庬	iiuh
廘	iixp
戎	ij
甫	ijb
朮	ijc
麻	ijcc
求	ije
庋	ije
廟	ijjb
庨	ijkd
庫	ijwj
犬	ik
義	ik
貵	ikbuc
參	ikhhh
飆	ikhni
猋	ikikk
軬	ikjwj
犮	ikk
庵	iklu
為	iknf
欸	ikno
慦	ikp
廗	ikpb
彧	ikrm
尤	iku
畚	ikw
庸	ilb
康	ile
州	ilil
廔	illv
庣	ilmo
划	iln
庚	ilo
賡	iloc
唐	ilr
冫	im
亠	im
凋	imbgr
凈	imbsd
凎	imc
庮	imcw
決	imdk
凍	imdw
冰	ime
凌	imgce
冼	imhgu
庢	imig
冹	imikk
冶	imir
凄	imjlv
沖	iml
凞	imlsf
冽	immnn
廲	immp
冱	immvm
凐	immwg
次	imno
准	imog
冷	imoii
凔	imoir
涂	imomd
冾	imomr
惑	imp
凝	impko
湊	imqkk
凊	imqmb
況	imrhu
臧	imsll
馮	imsqf
凘	imtcl
廈	imue
凗	imuog
庌	imvh
凅	imwjr
涼	imyrf
凜	imywd
廨	inbq
永	ine
廯	infq
序	inin
庭	inkg
廕	inli
之	ino
廢	inoe
庂	io
盜	iobt
資	iobuc
庥	iod
栥	iod
府	iodi
粢	iofd
膺	iogb
鷹	iogf
應	iogp
鶊	iohaf
秶	iohd
腐	ioib
庈	ioin
矣	iok
廥	ioma
瓷	iomvn
座	ioog
餈	iooiv
恣	iop
咨	ior
楶	iord
廡	iotf
姿	iov
弋	ip
庀	ip
麆	ipbm
貣	ipbuc
鏖	ipc
熊	ipf
麃	ipf
麋	ipfd
麟	ipfdq
塵	ipg
鳶	iphaf
麇	iphd
麝	iphhi
麂	iphn
麔	iphor
麑	iphxu
麙	ipihr
麤	ipipp
螚	iplmi
式	ipm
廎	ipmc
貳	ipmmc
麎	ipmmv
麜	ipmwd
麠	ipmwm
鄜	ipnl
麛	ipnsj
隿	ipog
態	ipp
庇	ipp
忒	ipp
麀	ipp
麚	iprse
庖	ipru
麌	iprvk
麒	iptmc
庉	ipu
麇	ipwhd
麈	ipyg
麍	ipyiu
麡	ipyx
鴾	iqhaf
緳	iqhf
庪	iqje
台	ir
枲	ird
炱	irf
鶶	irhaf
或	irm
顑	irmbc
瓵	irmvn
觱	irnbg
邰	irnl
感	irp
怠	irp
盛	isbt
廳	isgp
廜	isja
廖	ismh
郕	isnl
敷	isok
廦	isrj
戒	it
弁	it
庴	ita
廝	itcl
度	ite
庶	itf
鴘	ithaf
席	itlb
廣	itlc
廑	itlm
庠	itq
庹	itso
庰	itt
廉	itxc
尨	iuhhh
戉	iv
廱	ivug
廛	iwcg
廩	iwrf
廙	iwtc
慶	ixe
廌	ixf
鹿	ixp
龐	iybp
廓	iydl
爢	iyf
劘	iyln
庛	iymp
廬	iypt
店	iyr
廩	iywd
十	j
睹	jabuu
煮	jaf
寔	jamo
都	janl
翥	jasmm
宴	jav
巿	jb
寀	jbd
鶦	jbhaf
櫜	jbhod
獻	jbik
宜	jbm
真	jbmc
直	jbmm
橐	jbmrd
蠹	jbmri
孛	jbnd
察	jbof
囊	jbrrv
南	jbtj
蟗	jbuui
索	jbvif
疐	jbwno
穴	jc
窩	jcbbr
窯	jcbou
窅	jcbu
窪	jcegg
窏	jcemd
窲	jcfdj
窾	jcgfo
窐	jcgg
灶	jcgru
竇	jcgwc
窵	jchaf
鷏	jchaf
竊	jchdb
窸	jchdp
窖	jchgr
窌	jchhl
窮	jchhn
窆	jchio
穾	jchk
窳	jchoo
竅	jchsk
竁	jchuu
窊	jchvo
窗	jchwk
窗	jchwn
竄	jchxv
戭	jci
突	jcik
窢	jcirm
窴	jcjbc
窙	jcjkd
究	jckn
帘	jclb
窶	jcllv
窕	jclmo
空	jcm
顛	jcmbc
穻	jcmd
窒	jcmig
竀	jcmmu
窉	jcmob
穿	jcmvh
穹	jcn
穵	jcn
冤	jcnai
窞	jcnhx
穸	jcni
窿	jcnlm
歕	jcno
窯	jcoju
窱	jcold
窬	jcomn
容	jcor
窄	jcos
窇	jcpru
竊	jcpsh
窀	jcpu
窫	jcqhk
窺	jcqou
窷	jcsjl
窘	jcskr
翸	jcsmm
窟	jcsuu
窯	jctgf
阱	jctt
窋	jcuu
窈	jcvis
窠	jcwd
窔	jcyck
窣	jcyoj
窨	jcyta
未	jd
宋	jd
鵓	jdhaf
守	jdi
勃	jdks
郣	jdnl
教	jdok
支	je
檕	jed
墼	jeg
麮	jegi
鳷	jehaf
麰	jeihq
轚	jejwj
蟿	jelmi
頍	jembc
麵	jemls
麵	jemwl
麵	jemys
罊	jeoju
麧	jeon
麴	jepfd
麭	jepru
擊	jeq
麩	jeqo
寖	jese
攳	jesmi
翅	jesmm
麴	jetw
麷	jeujt
繫	jevif
麶	jeyub
宵	jfb
鶴	jghaf
審	jhdw
客	jher
宎	jhk
冗	jhn
寙	jhoo
宅	jhp
牢	jhq
宒	jhqu
寫	jhxf
博	jibi
栽	jid
專	jidi
鷒	jihaf
宬	jihs
載	jijwj
寪	jikf
蛓	jilmi
剸	jiln
酨	jimcw
臷	jimig
磚	jimvn
鄟	jinl
胾	jiobo
截	jiog
惠	jip
哉	jir
戴	jiwtc
裁	jiyhv
廾	jj
廾	jj
轀	jjabt
輥	jjapp
輵	jjapv
朝	jjb
輣	jjbb
寘	jjbc
輖	jjbgr
輞	jjbtv
輍	jjcor
韓	jjdmq
輟	jjeee
輎	jjfb
轔	jjfdq
輘	jjgce
轖	jjgow
轅	jjgrv
輈	jjhby
轓	jjhdw
輅	jjher
軠	jjhg
輴	jjhju
轎	jjhkb
斬	jjhml
軗	jjhne
軓	jjhni
軧	jjhpm
軼	jjhqo
軞	jjhqu
軶	jjhsn
軱	jjhvo
軝	jjhvp
輗	jjhxu
戟	jji
輚	jjii
輔	jjijb
軷	jjikk
軾	jjipm
軩	jjir
轗	jjirp
轆	jjixp
轉	jjjii
轟	jjjjj
輐	jjjmu
轄	jjjqr
轒	jjjtc
軑	jjk
轑	jjkcf
軌	jjkn
軮	jjlbk
寁	jjlo
軸	jjlw
軟	jjmbk
輀	jjmbl
軯	jjmfj
轣	jjmhm
輊	jjmig
軒	jjmj
輛	jjmlb
轉	jjmmi
軻	jjmnr
輻	jjmrw
軛	jjmsu
軏	jjmu
輕	jjmvm
輓	jjnau
輮	jjnhd
軟	jjno
輹	jjoae
軜	jjob
榦	jjod
軵	jjodi
鶾	jjohf
軫	jjohh
軨	jjoii
軡	jjoin
螒	jjoli
輪	jjomb
輇	jjomg
幹	jjomj
輸	jjomn
輸	jjomv
乾	jjon
雗	jjoog
翰	jjosm
斡	jjoyj
軥	jjpr
軘	jjpu
輷	jjpyr
轃	jjqkd
輳	jjqkk
輤	jjqmb
軹	jjrc
軦	jjrhu
輯	jjrsj
軔	jjshi
軺	jjshr
轞	jjsit
輒	jjsju
軔	jjsk
輑	jjskr
轇	jjsmh
轞	jjsmt
轏	jjsnd
輾	jjstv
轕	jjtav
輁	jjtc
轐	jjtco
輶	jjtcw
轙	jjtgi
轛	jjtgi
軿	jjtt
軋	jju
輲	jjumb
轢	jjvid
轈	jjvvd
輜	jjvvw
輠	jjwd
轘	jjwlv
轀	jjwot
轠	jjwww
轍	jjybk
較	jjyck
軴	jjyg
轋	jjyjj
軿	jjyjj
轤	jjypt
輬	jjyrf
輆	jjyvo
丈	jk
者	jka
宥	jkb
寮	jkcf
鶟	jkhaf
宏	jki
斄	jkmdo
漦	jkme
犛	jkmhq
氂	jkmhu
孷	jkmnd
寄	jkmr
剺	jkmsh
嫠	jkmv
考	jkmvs
釐	jkmwg
宄	jkn
孝	jknd
老	jkp
耇	jkpr
協	jkss
考	jkys
暫	jla
鏨	jlc
槧	jld
塹	jlg
衷	jlhv
吏	jlk
事	jlln
寠	jllv
宨	jlmo
磛	jlmr
蹔	jlryo
妻	jlv
宙	jlw
疌	jlyo
士	jm
宣	jmam
鑋	jmc
寡	jmch
宇	jmd
賓	jmhc
室	jmig
矗	jmjmm
寅	jmlc
賨	jmmc
宗	jmmf
完	jmmu
宸	jmmv
宁	jmn
宕	jmr
富	jmrw
家	jmso
寶	jmuc
寇	jmue
定	jmyo
冤	jnai
字	jnd
鸋	jnhaf
宛	jniu
剚	jnln
惌	jnup
寯	jogs
宿	joma
顁	jombc
麥	joni
寑	jose
它	jp
耆	jpa
寧	jpbn
甯	jpbq
寍	jpbt
宓	jph
蜜	jphi
耄	jphqu
密	jphu
寲	jpko
耋	jpmig
害	jqjr
憲	jqmp
害	jqmr
古	jr
胡	jrb
鶘	jrbhf
豁	jrcor
鴣	jrhaf
鶷	jrhaf
毄	jrhne
宮	jrhr
克	jrhu
割	jrln
官	jrlr
額	jrmbc
故	jrok
悹	jrrp
嘏	jrrse
辜	jrytj
冤	jshi
宭	jskr
宦	jsll
寥	jsmh
卉	jt
寞	jtak
賁	jtbc
寬	jtbi
賽	jtcc
寨	jtcd
騫	jtcf
塞	jtcg
蹇	jtco
搴	jtcq
謇	jtcr
寋	jtcu
褰	jtcv
寒	jtcy
鼖	jtge
七	ju
剋	judi
鵷	juhaf
兢	jujru
勀	juks
剜	juln
剋	juln
安	jv
案	jvd
鶈	jvhaf
鴳	jvhaf
寎	jvmb
頞	jvmbc
寐	jvmd
寱	jvmd
寢	jvme
寤	jvmr
寣	jvmr
郪	jvnl
覾	jwbuu
車	jwj
實	jwjc
寓	jwlb
寰	jwlv
寊	jybc
寵	jybp
寂	jyfe
宰	jytj
大	k
乂	k
瘟	kabt
疸	kam
瘍	kamh
癇	kanb
奲	karrj
疤	kau
痕	kav
有	kb
冇	kb
痭	kbb
瘑	kbbr
癭	kbcv
鵗	kbhaf
殽	kbhne
毻	kbhqu
戫	kbirm
疽	kbm
痌	kbmr
瓻	kbmvn
郗	kbnl
郁	kbnl
郩	kbnl
欷	kbno
瘵	kbof
閷	kcano
殺	kchne
弒	kcipm
剎	kcln
痳	kdd
疲	kdhe
殺	kdhne
弒	kdipm
癩	kdlc
剎	kdln
瘌	kdln
友	ke
痧	kefh
瘙	keii
奫	kell
灰	kf
疢	kf
痟	kfb
盔	kfbt
瘠	kfcb
痰	kff
癆	kffs
鷯	kfhaf
悐	kfp
痔	kgdi
奎	kgg
鵟	kghaf
痣	kgp
猖	khaa
猩	khahm
癤	khal
狚	kham
猑	khapp
猲	khapv
狠	khav
獌	khawe
猾	khbbb
猧	khbbr
狙	khbm
狪	khbmr
痸	khbn
猺	khbou
猙	khbsd
狦	khbtt
狽	khbuc
玃	khbue
癪	khdc
痵	khdd
獺	khdlc
痢	khdn
痿	khdv
猀	khefh
疼	khey
狄	khf
獙	khfbk
獟	khggu
狤	khgr
猿	khgrv
猘	khhbn
猁	khhdn
狅	khhg
獯	khhgf
獢	khhkb
奅	khhl
猦	khhni
狌	khhqm
獅	khhrb
猵	khhsb
猏	khhsb
獥	khhsk
狐	khhvo
瘤	khhw
猈	khhwj
獀	khhxe
獡	khhxf
猊	khhxu
狼	khiav
猼	khibi
狻	khice
狁	khihu
狨	khij
疺	khio
獷	khitc
狘	khiv
狖	khjc
狩	khjdi
獑	khjjl
豬	khjka
狫	khjkp
獰	khjpn
狜	khjr
猢	khjrb
獠	khkcf
狶	khkkb
猗	khkmr
犰	khkn
狹	khkoo
狆	khl
狒	khlln
狣	khlmo
狟	khmam
獳	khmbb
獶	khmbe
獿	khmce
獮	khmfb
狉	khmfm
狂	khmg
獂	khmhf
犴	khmj
狋	khmmf
獗	khmto
犽	khmvh
獬	khnbq
猻	khndf
猛	khndt
疫	khne
狃	khng
峱	khngu
獝	khnhb
猱	khnhd
瘋	khni
狿	khnkm
獼	khnmb
狑	khoii
獊	khoir
癥	khok
癓	khok
獪	khoma
狳	khomd
獫	khomo
猞	khomr
犵	khon
猴	khonk
瘲	khoo
痻	khpa
狴	khppg
狗	khpr
猰	khqhk
狾	khqhl
獉	khqkd
猜	khqmb
狷	khrb
玁	khrrk
猳	khrse
狔	khsp
犯	khsu
獦	khtav
獛	khtco
猶	khtcw
玂	khtjl
獚	khtlc
獲	khtoe
獾	khtrg
貓	khtw
癟	khub
猣	khuce
瘣	khui
瘜	khup
猭	khvno
疧	khvp
獵	khvvv
猓	khwd
狸	khwg
痺	khwj
狎	khwl
玀	khwlg
獨	khwli
獧	khwlv
猥	khwmv
瘦	khxe
瘐	khxo
癙	khxv
狡	khyck
瘢	khye
犺	khyhn
獩	khymh
狺	khymr
猝	khyoj
猇	khypu
獄	khyrk
獽	khyrv
獞	khytg
獐	khytj
獍	khytu
犿	khyy
太	ki
痠	kice
痡	kijb
疣	kiku
雄	kiog
翃	kismm
痝	kiuh
奿	kiv
瘨	kjbc
癲	kjcc
痲	kjcc
奢	kjka
瘏	kjka
痚	kjkd
痯	kjrr
奔	kjt
爻	kk
肴	kkb
痏	kkb
療	kkcf
鷞	kkhaf
鸑	kkhaf
爽	kkkk
希	kklb
痷	kklu
痍	kkn
瘞	kkog
瘱	kkop
瘸	kkrb
夯	kks
痂	kksr
布	klb
在	klg
夼	klll
疿	klln
痋	klmi
痱	klmy
刈	kln
存	klnd
奄	klwu
左	km
疘	km
奭	kmaa
癗	kmbw
痞	kmfr
奈	kmmf
痦	kmmr
夸	kmms
疔	kmn
奇	kmnr
痾	kmnr
病	kmob
痘	kmrt
瘃	kmso
痙	kmvm
瘭	kmwf
症	kmym
九	kn
夷	kn
旭	kna
旮	kna
瘓	knbk
癚	kncr
癬	knfq
鳩	knhaf
丸	kni
厹	kni
痛	knib
奓	knin
痑	knin
癃	knlm
癮	knlp
痾	knlr
頄	knmbc
疚	kno
癈	knoe
馗	knthu
訄	knymr
虓	knypu
痽	kog
奪	kogi
奮	kogw
鵊	kohaf
疹	kohh
瘡	koir
疾	kok
痴	kokr
疥	koll
癐	koma
頰	kombc
痊	komg
瘉	komn
癒	komp
疙	kon
瘊	konk
郟	konl
夾	koo
痤	koog
痄	kos
痗	kowy
疕	kp
帶	kpblb
癡	kpko
疪	kpp
痀	kpr
疶	kpt
瘈	kqhk
瘛	kqhp
右	kr
賀	krbuc
疻	krc
架	krd
鵸	krhaf
鴐	krhaf
毠	krhqu
攲	krje
剞	krln
哿	krmnr
欹	krno
癉	krrj
癌	krru
瘕	krse
駕	krsqf
敧	krye
袈	kryhv
力	ks
癜	ksce
鴮	kshaf
綔	kshvf
瓠	kshvo
耷	ksj
脅	ksksb
劦	kskss
姭	ksksv
刳	ksln
瘺	ksmb
瘳	ksmh
套	ksmi
匏	kspru
加	ksr
癖	ksrj
奩	ksrr
勰	kswp
瘼	ktak
痶	ktbc
瘔	ktjr
瘽	ktlm
疳	ktm
癱	ktog
瘩	ktor
癢	ktov
癢	ktq
羍	ktq
瘥	ktqm
瘚	ktuo
癘	ktwb
疝	ku
尢	ku
尳	kubbb
鵪	kuhaf
尰	kuhjg
尪	kumg
尬	kuoll
尥	kupi
尷	kusit
尷	kusmt
癵	kvfb
癰	kvug
痼	kwjr
瘝	kwle
痹	kwml
瘟	kwot
痐	kwr
瘰	kwvf
疰	kyg
疵	kymp
瘁	kyoj
瘧	kypm
痁	kyr
瘯	kysk
瘀	kysy
瘖	kyta
瘴	kytj
痎	kyvo
癠	kyx
中	l
衵	la
裮	laa
袒	lam
褆	lamo
襉	lanb
襴	lanw
裼	laph
褐	lapv
褟	lasm
襮	late
裉	lav
巾	lb
帽	lbabu
幌	lbafu
帊	lbau
幔	lbawe
幜	lbayf
幎	lbbac
幍	lbbhx
帨	lbcru
帔	lbdhe
幃	lbdmq
帩	lbfb
幬	lbgni
裯	lbgr
帕	lbha
幯	lbhal
幡	lbhdw
帆	lbhni
帙	lbhqo
幮	lbigi
帴	lbii
幓	lbiih
帗	lbikk
褌	lbjj
帾	lbjka
幏	lbjmo
幰	lbjqp
幩	lbjtc
央	lbk
帎	lblbu
袓	lbm
幁	lbmbc
幊	lbmbc
褑	lbme
帄	lbmn
幅	lbmrw
幨	lbncr
鄁	lbnl
帷	lbog
帢	lbomr
幠	lbotf
幘	lbqmc
裯	lbqr
幧	lbrrd
幝	lbrrj
幄	lbsmg
帳	lbsmv
盅	lbt
幙	lbtak
幪	lbtbo
幞	lbtco
帡	lbtt
幭	lbtwi
冘	lbu
幗	lbwim
幀	lbybc
幟	lbyia
帖	lbyr
幢	lbytg
幛	lbytj
鄪	lcnl
裕	lcor
裞	lcru
衯	lcsh
襋	ldbb
襟	lddf
襻	lddq
被	ldhe
袂	ldk
褘	ldmq
隶	le
褬	leed
裰	leee
衩	lei
襒	lfbk
襠	lfbw
裧	lff
袢	lfq
裷	lfqu
書	lga
晝	lgam
袡	lgb
裬	lgce
襓	lggu
褂	lggy
袪	lgi
袺	lgr
襭	lgrc
襩	lgwc
畫	lgwm
袙	lha
襖	lhbk
袶	lheq
袼	lher
衽	lhg
衫	lhhh
袾	lhjd
褷	lhoo
袛	lhpm
袟	lhqo
褊	lhsb
襣	lhul
衹	lhvp
裨	lhwj
褫	lhyu
蚎	lia
蝐	liabu
蝞	liahu
蝍	liail
蝪	liamh
蝭	liamo
蜴	liaph
蝎	liapv
蚆	liau
蛝	liav
蠍	liavo
蟃	liawe
螟	libac
螖	libbb
蝸	libbr
蠳	libcv
蛶	libdi
蜩	libgr
蛆	libm
蝯	libme
蜉	libnd
褦	libp
蠼	libue
蠷	libug
蜆	libuu
螇	libvk
蚣	lici
螉	licim
蚥	lick
蛻	licru
蚡	licsh
蚞	lid
蜙	lidci
蚾	lidhe
蜥	lidhl
蚗	lidk
蝀	lidw
蝃	lieee
蟝	liesd
蛸	lifb
螳	lifbg
蟷	lifbw
蠑	liffd
蟧	liffs
蜷	lifqu
蚺	ligb
蛙	ligg
蟯	liggu
蛣	ligr
蟢	ligrr
蟛	ligth
蟂	lihad
蝗	lihag
蝌	lihdj
蜊	lihdn
蟋	lihdp
蜲	lihdv
蟠	lihdw
蜂	lihej
蛛	lihjd
蝩	lihjg
蛞	lihjr
蟜	lihkb
蝺	lihlb
蚚	lihml
蚸	lihmy
虮	lihn
虴	lihp
蚳	lihpm
蛾	lihqi
蛈	lihqo
蚝	lihqu
螄	lihrb
螐	lihrf
蝙	lihsb
蜧	lihsk
蚅	lihsu
螝	lihui
螑	lihuk
螅	lihup
蛌	lihvo
蚔	lihvp
蜱	lihwj
蟌	lihwp
蜺	lihxu
螔	lihyu
蜋	liiav
襂	liih
蛑	liihq
蝛	liihv
螂	liiil
蜅	liijb
蛷	liije
蟡	liikf
蛂	liikk
蚘	liiku
螗	liilr
蠀	liioc
蜮	liirm
蠊	liitc
蟅	liitf
蝷	liitu
蛖	liiuh
螰	liixp
補	lijb
蝻	lijbj
螲	lijcg
蚑	lije
蟪	lijip
褲	lijj
螹	lijjl
蝫	lijka
蜨	lijlo
蠙	lijmc
蚓	lijmc
蝖	lijmm
蜿	lijnu
蛇	lijp
螛	lijqr
蛄	lijr
蝴	lijrb
蟦	lijtc
蟟	likcf
袚	likk
蛦	likn
螏	likok
蛺	likoo
螮	likpb
蟲	lilii
蠱	lilit
蝂	lille
螻	lillv
蚰	lilw
蜵	lilxl
虹	lim
蛨	lima
蠕	limbb
蝢	limbc
蝡	limbk
蚽	limfm
螈	limhf
蛭	limig
虷	limj
蚖	limmu
蜄	limmv
虰	limn
蛚	limnn
蚵	limnr
蛃	limob
蝠	limrw
蠣	limtb
蚜	limvh
蛵	limvm
螵	limwf
蟫	limwj
蝒	limwl
蟓	linao
蝜	linbc
蟾	lincr
蜢	lindt
蝚	linhd
蜭	linhx
蛹	linib
蜓	linkg
蜒	linkm
蚓	linl
蛫	linmu
蝑	linob
蝮	lioae
蚋	liob
蚹	liodi
蜼	liog
蟭	liogf
蛉	lioii
蚙	lioin
蜘	liokr
蚧	lioll
蚯	liom
蜦	liomb
蜍	liomd
蝓	liomn
蛤	liomr
蝓	liomv
虼	lion
蜁	liono
蟘	liopc
蚱	lios
蛜	liosk
虳	lipi
蚐	lipmm
蜪	lipou
蚍	lipp
蝔	lippa
蜌	lippg
蚼	lipr
蝶	liptd
蚌	liqj
螓	liqkd
蜻	liqmb
蝳	liqmy
蚨	liqo
蜎	lirb
蟬	lirrj
蝦	lirse
蟤	liruc
蜈	lirvk
蠅	lirxu
蝘	lisav
蠾	lisei
蠮	lisem
虭	lish
蛁	lishr
蜛	lisjr
蠗	lismg
蟉	lismh
蟳	lismi
蚇	liso
螞	lisqf
蟶	lisrg
蚷	liss
蜡	lita
蟆	litak
褯	litb
蠓	litbo
蝤	litcw
蟻	litgi
蜣	litgu
蟒	litit
蟥	litlc
蝧	litlk
螼	litlm
蠨	litlx
蚶	litm
蜞	litmc
蠖	litoe
蠂	litpd
蛘	litq
蝆	litq
蠸	litrg
蛢	litt
蛐	litw
螬	litwa
蠛	litwi
虯	liu
蝬	liuce
螘	liumt
蜬	liune
蠵	liuob
蟣	livii
蚴	livis
虯	livl
蝝	livno
蠟	livvv
蝟	liwb
蜾	liwd
蟔	liwgf
蜠	liwhd
蟈	liwim
蠋	liwli
蠌	liwlj
蠉	liwlv
蝹	liwot
蛔	liwr
螺	liwvf
蠝	liwww
螁	liyav
蠬	liybp
螃	liybs
螪	liycb
蛟	liyck
蛀	liyg
蚢	liyhn
蟙	liyia
蟀	liyij
蚪	liyj
蚊	liyk
蠦	liypt
蛅	liyr
蠩	liyra
蜳	liyrd
蝏	liyrn
蠔	liyro
蠰	liyrv
蝣	liysd
蟑	liytj
螭	liyub
虻	liyv
蚿	liyvi
蟺	liywm
蠐	liyx
袕	ljc
褣	ljcr
衼	lje
襶	ljic
褚	ljka
袉	ljp
史	lk
盎	lkbt
鴦	lkhaf
袸	lkld
裺	lklu
襫	lkma
褲	lkms
裌	lkoo
串	ll
衶	ll
暢	llamh
衴	llbu
朄	lldwf
牉	llfq
牘	llgwc
版	llhe
牖	llhsb
牌	llhwj
牋	llii
川	lll
順	lllc
褸	lllv
片	llml
裶	llmy
弗	lln
牏	llomn
患	llp
褙	llpb
牒	llptd
牊	llshr
婁	llv
袖	llw
丳	llww
裫	llxl
牓	llybs
袹	lma
襦	lmbb
貴	lmbuc
衧	lmd
賮	lmfbc
盡	lmfbt
虫	lmi
裲	lmlb
劃	lmln
襹	lmmp
裖	lmmv
北	lmp
邶	lmpnl
裋	lmrt
褔	lmrw
非	lmsy
剕	lmsyn
兆	lmuo
頫	lmuoc
覜	lmuou
褥	lmvi
褾	lmwf
褼	lmwu
鬥	ln
冖	ln
襐	lnao
費	lnbuc
襜	lncr
衱	lnhe
鬩	lnhxu
襁	lnii
刜	lnln
鬫	lnmjk
鬥	lnmti
艴	lnnau
鬮	lnnxu
襏	lnoe
鬥	lnrml
鬨	lntc
鬧	lnylb
複	loae
衲	lob
袗	lohh
袱	loik
襳	loim
衿	loin
襘	loma
褕	lomn
襝	lomo
袷	lomr
褕	lomv
袘	lopd
褓	lord
忠	lp
背	lpb
衪	lpd
袀	lpmm
袧	lpr
袍	lpru
褋	lptd
冀	lpwtc
聿	lq
褉	lqhk
衋	lqmat
裱	lqmv
衭	lqo
裐	lrb
裎	lrhg
裎	lrmg
襙	lrrd
襌	lrrj
冂	ls
褗	lsav
初	lsh
袑	lshr
襤	lsit
裾	lsjr
裙	lskr
褶	lsma
襑	lsmi
韭	lsmm
襤	lsmt
襺	ltbi
襆	ltco
襼	ltgi
褡	ltor
襪	ltwi
襛	ltwv
儿	lu
沊	lue
鴆	luhaf
邥	lunl
胤	lvbu
鷜	lvhaf
氀	lvhqu
袎	lvis
褖	lvno
數	lvok
袽	lvr
由	lw
冑	lwb
冑	lwb
裸	lwd
裍	lwd
裡	lwg
裀	lwk
申	lwl
襡	lwli
襗	lwlj
襬	lwlp
甹	lwmvs
褞	lwot
曳	lwp
肅	lx
鷫	lxhaf
褪	lyav
褅	lybb
襱	lybp
棐	lyd
襯	lydu
裗	lyiu
褳	lyjj
輩	lyjwj
奜	lyk
蜚	lylmi
餥	lyoiv
悲	lyp
翡	lysmm
襚	lyto
褵	lyub
婓	lyv
袨	lyvi
襢	lywm
裴	lyyhv
斐	lyyk
一	m
百	ma
厭	mabk
櫫	mad
厬	mahr
戩	mai
亙	mam
皕	mama
碧	mamr
厚	mand
鄑	manl
霾	mbbhg
霢	mbbhv
霥	mbbmo
廁	mbcn
雰	mbcsh
霜	mbdbu
霖	mbdd
霦	mbddh
耐	mbdi
霪	mbebg
霘	mbebr
霂	mbed
霈	mbejb
靋	mbemm
霐	mbeni
霟	mbetc
霮	mbetv
霑	mbeyr
霄	mbfb
鷊	mbhaf
鸍	mbhaf
鴯	mbhaf
雽	mbhfd
耏	mbhhh
霤	mbhhw
霺	mbhok
霓	mbhxu
戛	mbi
霋	mbjlv
耎	mbk
勵	mbks
雵	mblbk
而	mbll
融	mblmi
雿	mblmo
霏	mblmy
電	mblwu
亙	mbm
需	mbmbl
璽	mbmgi
靂	mbmhm
雲	mbmmi
雩	mbmms
震	mbmmv
霧	mbnhs
霿	mbnhu
雺	mbnih
霆	mbnkg
邴	mbnl
霯	mbnot
鬺	mboah
霍	mbog
靃	mbogg
零	mboii
霉	mbowy
恧	mbp
憂	mbphe
雹	mbpru
霣	mbrbc
霵	mbrji
露	mbrmr
靈	mbrro
霝	mbrrr
霞	mbrse
霨	mbsfi
雪	mbsm
霫	mbsma
翮	mbsmm
霹	mbsrj
霰	mbtbk
霸	mbtjb
霙	mbtlk
雸	mbtm
頁	mbuc
貢	mbuc
鬷	mbuce
耍	mbv
雷	mbw
霬	mbwtc
電	mbwu
靇	mbybp
霩	mbydl
雱	mbyhs
雯	mbyk
霅	mbymr
靄	mbyrv
霠	mbytn
霎	mbytv
霽	mbyx
夒	mche
西	mcw
酉	mcwm
于	md
盂	mdbt
鷅	mdhaf
五	mdm
邘	mdnl
汞	me
亟	mem
鄾	menl
不	mf
爾	mfbk
甭	mfbq
盃	mfbt
覝	mfbuu
鴀	mfhaf
彯	mfhhh
飄	mfhni
瓢	mfhvo
平	mfj
奀	mfk
剽	mfln
丕	mfm
願	mfmbc
顠	mfmbc
歪	mfmym
鄢	mfnl
愿	mfp
否	mfr
翲	mfsmm
孬	mfvnd
王	mg
琩	mgaa
瑁	mgabu
瑆	mgahm
瑂	mgahu
瑒	mgamh
琨	mgapp
琶	mgau
璟	mgayf
琝	mgayk
再	mgb
玥	mgb
璦	mgbbe
珊	mgbbm
琛	mgbcd
瓔	mgbcv
琱	mgbgr
琿	mgbjj
珇	mgbm
瑗	mgbme
琈	mgbnd
瑤	mgbou
琤	mgbsd
珊	mgbt
珼	mgbuc
現	mgbuu
玬	mgby
珶	mgcnh
玢	mgcsh
璔	mgcwa
琳	mgdd
玻	mgdhe
玦	mgdk
瑋	mgdmq
琺	mgegi
瑵	mgeii
瑣	mgfbc
璫	mgfbw
璘	mgfdq
琰	mgff
珖	mgfmu
珃	mggb
珪	mggg
瓙	mggnf
璈	mggsk
珀	mgha
瑔	mghae
鳿	mghaf
珘	mghby
琍	mghdn
琇	mghds
璠	mghdw
致	mghe
珞	mgher
珗	mghgu
珋	mghhl
琉	mghhw
珠	mghjd
瑀	mghlb
珮	mghnb
珩	mghon
瑽	mghoo
珴	mghqi
瓚	mghuc
瑰	mghui
璁	mghwp
璵	mghxc
玉	mgi
玊	mgi
琅	mgiav
瑊	mgihr
臹	mgihs
琖	mgii
瑯	mgiil
球	mgije
班	mgilg
瑭	mgilr
珆	mgir
璷	mgisk
瑱	mgjbc
瑏	mgjch
瑢	mgjcr
瑼	mgjii
璸	mgjmc
琮	mgjmf
瑄	mgjmm
琬	mgjnu
瑚	mgjrb
琯	mgjrr
珛	mgkb
琋	mgkkb
珔	mgkld
琦	mgkmr
珈	mgksr
玔	mglll
珧	mglmo
璶	mglmt
琲	mglmy
到	mgln
珒	mglq
珅	mglwl
玒	mgm
瓀	mgmbb
頊	mgmbc
玗	mgmd
玶	mgmfj
玨	mgmg
璱	mgmgh
琊	mgmhl
臸	mgmig
玕	mgmj
珸	mgmmr
玩	mgmmu
玎	mgmn
珂	mgmnr
琢	mgmso
玡	mgmvh
甄	mgmvn
瑮	mgmwd
瓊	mgnbe
瑍	mgnbk
璚	mgnhb
珽	mgnkg
郅	mgnl
鄄	mgnl
玖	mgno
歅	mgno
璒	mgnot
珍	mgohh
玲	mgoii
琴	mgoin
玳	mgoip
瑲	mgoir
琀	mgoir
玝	mgoj
致	mgok
玫	mgok
玠	mgoll
璯	mgoma
瑜	mgomn
珨	mgomr
瑜	mgomv
琁	mgono
珣	mgpa
瑟	mgph
珌	mgph
玓	mgpi
琵	mgpp
玭	mgpp
瑎	mgppa
玸	mgpru
玴	mgpt
玤	mgqj
臻	mgqkd
琫	mgqkq
琄	mgrb
珵	mgrhg
璐	mgrmr
噩	mgrr
璪	mgrrd
瑕	mgrse
珿	mgryo
玿	mgshr
珥	mgsj
琚	mgsjr
珺	mgskr
璆	mgsmh
璕	mgsmi
璻	mgsmj
珝	mgsmm
瑪	mgsqf
弄	mgt
琠	mgtbc
瑐	mgtbn
珙	mgtc
璞	mgtco
瓂	mgtgt
璊	mgtlb
璜	mgtlc
瑛	mgtlk
瑾	mgtlm
玵	mgtm
琪	mgtmc
瑹	mgtod
瓁	mgtoe
珜	mgtq
瑳	mgtqm
瓘	mgtrg
璥	mgtrk
瑞	mgumb
瓗	mguob
璀	mguog
琌	mguon
瓅	mgvid
璣	mgvii
琭	mgvne
瑑	mgvno
璅	mgvvd
瑙	mgvvw
理	mgwg
珚	mgwk
玾	mgwl
環	mgwlv
瓃	mgwww
璭	mgybj
瓛	mgybk
瓏	mgybp
璿	mgybu
珓	mgyck
璨	mgyed
琡	mgyfe
琉	mgyiu
珫	mgyiu
璉	mgyjj
玟	mgyk
斑	mgykg
玼	mgymp
璡	mgyog
璩	mgypo
琥	mgypu
玷	mgyr
瓖	mgyrv
璇	mgyso
璋	mgytj
璲	mgyto
琣	mgytr
璃	mgyub
玹	mgyvi
瑰	mgywv
璾	mgyx
瓋	mgyyb
厂	mh
原	mhaf
曆	mhda
厤	mhdd
歷	mhdm
磿	mhdr
鴉	mhhaf
厜	mhjm
邪	mhnl
雅	mhog
餮	mhoiv
厎	mhpm
靉	mibbe
至	mig
魂	mihui
晉	miia
鄏	minl
霒	mioin
厖	miuh
靆	miyle
干	mj
厧	mjbc
烎	mjf
鳱	mjhaf
鷣	mjhaf
麉	mjixp
刊	mjln
頇	mjmbc
幵	mjmj
邢	mjmjl
刑	mjmjn
邗	mjnl
敢	mjok
舌	mjr
厙	mjwj
天	mk
壓	mkg
甦	mkhqm
魘	mkhui
靨	mkmwl
郠	mknl
饜	mkoiv
忝	mkp
憨	mkp
吞	mkr
功	mks
无	mku
嬮	mkv
黶	mkwgf
厴	mkwl
丌	ml
兩	mlbo
雨	mlby
亞	mllm
工	mlm
州	mlml
厞	mlmy
丏	mlvs
更	mlwk
二	mm
麗	mmbbp
項	mmbc
示	mmf
堊	mmg
鵡	mmhaf
鵛	mmhaf
云	mmi
厔	mmig
勁	mmks
亓	mml
蝁	mmlmi
剄	mmln
三	mmm
頸	mmmbc
辰	mmmv
亍	mmn
邳	mmnl
次	mmno
政	mmok
惡	mmp
吾	mmr
廚	mmti
元	mmu
廈	mmue
黿	mmuu
厊	mmvh
瓨	mmvn
巧	mmvs
巰	mmyiu
虣	mmypu
丁	mn
殂	mnbm
殍	mnbnd
銎	mnc
烈	mnf
型	mng
殪	mngbt
殰	mngwc
殦	mnhaf
鴷	mnhaf
殈	mnhbt
殊	mnhjd
殀	mnhk
歿	mnhne
殙	mnhpa
殠	mnhuk
歹	mni
殘	mnii
殏	mnije
殆	mnir
殖	mnjbm
殯	mnjmc
殥	mnjmc
殑	mnjru
殗	mnklu
殎	mnkoo
殢	mnkpb
邛	mnl
殃	mnlbk
殔	mnle
蛩	mnlmi
列	mnln
肂	mnlq
頂	mnmbc
殛	mnmem
殌	mnmvm
殭	mnmwm
歿	mnne
鮤	mnnwf
殤	mnoah
殄	mnohh
殲	mnoim
殮	mnomo
死	mnp
恐	mnp
殉	mnpa
歾	mnphh
可	mnr
殞	mnrbc
殫	mnrrj
跫	mnryo
鞏	mntlj
殣	mntlm
姴	mnv
殟	mnwot
殧	mnyfu
裂	mnyhv
殕	mnytr
仄	mo
豝	moau
豤	moav
丙	mob
資	mobuc
覡	mobuu
豯	mobvk
栥	mod
燹	mof
贗	mofc
粢	mofd
豷	mogbt
鷢	mohaf
鴈	mohf
豵	mohoo
豟	mohsn
豬	mojka
豶	mojtc
厒	moju
攻	mok
豨	mokkb
蟨	molmi
劂	moln
剢	moln
豲	momhf
豜	momjj
豩	momso
豜	momt
瓷	momvn
巫	moo
雁	moog
餈	mooiv
恣	mop
咨	mor
豭	morse
厏	mos
姿	mov
豱	mowot
豥	moyvo
鸝	mphaf
酈	mpnl
武	mpylm
石	mr
碭	mramh
礙	mrami
碣	mrapv
硍	mrav
硼	mrbb
碢	mrbbr
碉	mrbgr
鞷	mrbj
鬲	mrbl
砠	mrbm
硐	mrbmr
碀	mrbsd
碙	mrbtu
硯	mrbuu
磎	mrbvk
砃	mrby
砏	mrcsh
磳	mrcwa
碴	mrdam
硹	mrdci
碄	mrdd
礎	mrddo
破	mrdhe
砵	mrdm
砅	mre
泵	mre
磉	mreed
磲	mresd
硝	mrfb
礑	mrfbw
磷	mrfdq
礯	mrfff
砂	mrfh
硅	mrgg
磽	mrggu
砝	mrgi
磕	mrgit
硈	mrgr
礂	mrgrr
磝	mrgsk
磻	mrhdw
硌	mrher
硞	mrhgr
砭	mrhio
硃	mrhjd
碫	mrhje
硾	mrhjm
礄	mrhkb
礩	mrhlc
斫	mrhml
砓	mrhne
矺	mrhp
砥	mrhpm
硪	mrhqi
碥	mrhsb
礉	mrhsk
砨	mrhsn
礸	mrhuc
磈	mrhui
碑	mrhwj
磃	mrhyu
硠	mriav
砯	mrie
磩	mrihf
鹼	mrihr
磣	mriih
磄	mrilr
礦	mritc
硥	mriuh
磌	mrjbc
硿	mrjcm
磚	mrjii
礗	mrjmc
碇	mrjmo
碗	mrjnu
確	mrjog
砣	mrjp
磍	mrjqr
硨	mrjwj
磢	mrkkk
碕	mrkmr
硤	mrkoo
砩	mrlln
刮	mrln
硉	mrlq
砷	mrlwl
矼	mrm
礝	mrmbb
碩	mrmbc
礭	mrmbg
礵	mrmbu
礌	mrmbw
硒	mrmcw
砰	mrmfj
砡	mrmgi
矸	mrmj
研	mrmjj
硬	mrmlk
砢	mrmnr
碔	mrmpm
砳	mrmr
磊	mrmrr
研	mrmt
礪	mrmtb
硎	mrmtn
矹	mrmu
磭	mrmvb
砑	mrmvh
硜	mrmvm
磹	mrmwj
礓	mrmwm
确	mrnbg
矷	mrnd
砐	mrnhe
矽	mrni
郚	mrnl
酃	mrnl
硊	mrnmu
砍	mrno
歌	mrno
磴	mrnot
磔	mrnqd
哥	mrnr
確	mrobg
碓	mrog
磼	mrogd
礁	mrogf
砱	mroii
敔	mrok
砎	mroll
碖	mromb
硢	mromd
矻	mron
砟	mros
礙	mrpko
砒	mrpp
砲	mrpru
砌	mrpsh
碟	mrptd
碃	mrqmb
磧	mrqmc
碡	mrqmy
砆	mrqo
隕	mrrbc
磾	mrrrj
礹	mrrrk
碬	mrrse
礥	mrsec
砲	mrsfk
礛	mrsit
砸	mrslb
磟	mrsmh
碼	mrsqf
礔	mrsrj
碾	mrstv
豆	mrt
碏	mrta
碘	mrtbc
礤	mrtbf
礞	mrtbo
礒	mrtgi
礡	mrtii
磺	mrtlc
碤	mrtlk
碪	mrtmv
磋	mrtqm
碰	mrttc
碰	mrttm
磁	mrtvi
磡	mrtvs
礣	mrtwi
磏	mrtxc
硭	mrtyv
磞	mrubb
碳	mrumf
磑	mrumt
磪	mruog
礫	mrvid
磯	mrvii
碌	mrvne
硱	mrwd
碅	mrwhd
碨	mrwmv
磥	mrwvf
礧	mrwww
砪	mrwyi
碲	mrybb
磅	mrybs
礅	mrydk
砫	mryg
硫	mryiu
碎	mryoj
砧	mryr
碻	mryrb
碠	mryrn
砬	mryt
碚	mrytr
磠	mrywi
万	ms
豕	msho
豖	msko
鄠	msnl
攷	msok
厄	msu
厝	mta
廝	mtcl
鳽	mthaf
形	mthhh
豍	mthwj
豉	mtje
豌	mtjnu
刑	mtln
豇	mtm
頭	mtmbc
邢	mtnl
郖	mtnl
雃	mtog
揅	mtq
豏	mttxc
厥	mtuo
厲	mtwb
兀	mu
朁	mua
蠶	muali
襾	mub
炁	muf
夏	muhe
戛	mui
奡	mukll
虺	mulmi
刓	muln
頑	mumbc
鬵	mumrb
豗	mumso
邧	munl
卼	munmu
畫	muw
匚	mv
脣	mvb
牙	mvdh
辱	mvdi
旡	mvku
蜃	mvlmi
瓦	mvni
互	mvnm
覅	mvphh
唇	mvr
巠	mvvm
醞	mwabt
醒	mwahm
覃	mwaj
醍	mwamo
酹	mwbdi
酮	mwbmr
賈	mwbuc
靦	mwbuu
釂	mwbwi
酚	mwcsh
栗	mwd
醂	mwdd
酎	mwdi
醊	mweee
粟	mwfd
厘	mwg
堙	mwg
鶝	mwhaf
酥	mwhd
酪	mwher
醺	mwhgf
酷	mwhgr
覂	mwhio
酘	mwhne
覆	mwhoe
酕	mwhqu
覈	mwhsk
醜	mwhui
醙	mwhxe
酸	mwice
醾	mwidd
醆	mwii
酺	mwijb
酬	mwill
醣	mwilr
醡	mwjcs
醏	mwjka
酵	mwjkd
酡	mwjp
酤	mwjr
醐	mwjrb
醃	mwklu
醢	mwkrt
酖	mwlbu
蠠	mwlii
醠	mwlkt
副	mwln
醓	mwlut
醹	mwmbb
醽	mwmbr
酐	mwmj
酬	mwmll
票	mwmmf
釃	mwmmp
酊	mwmn
酠	mwmnr
醥	mwmwf
醰	mwmwj
酩	mwnir
醑	mwnob
醱	mwnoe
醀	mwog
醮	mwogf
酴	mwomd
酢	mwos
酯	mwpa
酏	mwpd
酌	mwpi
酌	mwpm
醄	mwpou
酲	mwrhg
酲	mwrmg
釅	mwrrk
面	mwsl
醪	mwsmh
醧	mwsrr
配	mwsu
醋	mwta
醭	mwtco
霸	mwtjb
羈	mwtjf
醼	mwtlf
酣	mwtm
醛	mwtog
醝	mwtqm
醴	mwtwt
醲	mwtwv
酗	mwuk
要	mwv
酳	mwvib
醁	mwvne
醳	mwwlj
醞	mwwot
醚	mwyfd
醯	mwyit
醉	mwyoj
醵	mwypo
酟	mwyr
醇	mwyrd
釀	mwyrv
醷	mwytp
醅	mwytr
醨	mwyub
歃	mxno
下	my
龐	mybp
焉	mylf
正	mylm
忑	myp
厗	mytj
丐	myvs
弓	n
亅	n
兔	nahi
免	nahu
象	napo
色	nau
弝	nau
觛	nbam
弸	nbb
敻	nbbue
觖	nbdk
觫	nbdl
觥	nbfmu
角	nbg
墮	nbg
觟	nbgg
鷸	nbhaf
觡	nbher
觝	nbhpm
氄	nbhqu
觚	nbhvo
觬	nbhxu
觩	nbije
觰	nbjka
奐	nbk
觭	nbkmr
勇	nbks
觔	nbks
触	nblmi
劀	nbln
觨	nbme
瓕	nbmgi
觼	nbnbe
觙	nbnhe
觤	nbnmu
觴	nboah
隳	nbop
恿	nbp
觶	nbrrj
解	nbshq
觲	nbtgq
觾	nbtlf
解	nbtq
嶞	nbu
負	nbuc
彏	nbue
觿	nbuob
觻	nbvid
觓	nbvl
觸	nbwli
斛	nbyj
小	nc
詹	ncymr
子	nd
孟	ndbt
鶔	ndhaf
孫	ndhvf
孤	ndhvo
孮	ndjmf
孻	ndlmt
孺	ndmbb
孲	ndmlm
孖	ndnd
孜	ndok
孢	ndpru
孔	ndu
孩	ndyvo
氶	ne
丞	nem
脀	nemb
烝	nemf
巹	nemsu
爾	nf
鯧	nfaa
鰣	nfagi
鯽	nfail
鯷	nfamo
鯤	nfapp
鰨	nfasm
鰻	nfawe
弰	nfb
鯛	nfbgr
鮦	nfbmr
鰶	nfbof
鰩	nfbou
鮵	nfcru
魵	nfcsh
粥	nfdn
鯠	nfdoo
鮹	nffb
鱨	nffba
鱗	nffdq
魦	nffh
鯪	nfgce
鯥	nfgcg
鮭	nfgg
鱙	nfggu
魼	nfgi
鮚	nfgr
鰉	nfhag
穌	nfhd
鯚	nfhdd
鰍	nfhdf
鱕	nfhdw
魬	nfhe
鮥	nfher
鰡	nfhhw
鱵	nfhir
鮢	nfhjd
鱎	nfhkb
鯦	nfhor
魠	nfhp
鰤	nfhrb
魴	nfhsb
鯀	nfhvf
鱮	nfhxc
鯓	nfhxh
鯢	nfhxu
鰔	nfihr
鯆	nfijb
鯄	nfije
魷	nfiku
鮐	nfir
鰫	nfjcr
鮇	nfjd
鱄	nfjii
鯇	nfjmu
鮀	nfjp
鰭	nfjpa
鮕	nfjr
鰗	nfjrb
鮪	nfkb
鮡	nflmo
鯡	nflmy
鱐	nflx
魟	nfm
鮞	nfmbl
鱈	nfmbm
魾	nfmfm
鱷	nfmgr
鯁	nfmlk
鱺	nfmmp
鯃	nfmmr
魺	nfmnr
鱱	nfmtb
鱖	nfmto
魱	nfmvm
鰾	nfmwf
鱌	nfnao
鮸	nfnau
鱊	nfnhb
鰇	nfnhd
鰎	nfnkq
鮠	nfnmu
鱍	nfnoe
鰒	nfoae
魶	nfob
鮒	nfodi
鯰	nfoip
鰷	nfold
鱠	nfoma
鮽	nfomd
鮯	nfomr
鯸	nfonk
魤	nfop
鮓	nfos
愻	nfp
鮨	nfpa
鮅	nfph
魡	nfpi
鮈	nfpr
鮑	nfpru
鰈	nfptd
魨	nfpu
鰆	nfqka
鯖	nfqmb
鰿	nfqmc
鱢	nfrrd
鱦	nfrxu
鰋	nfsav
鰹	nfseg
魛	nfsh
鯫	nfsje
鮿	nfsju
鮶	nfskr
鰼	nfsma
鯞	nfsmb
鱘	nfsmi
鱔	nftgr
鰳	nftjs
魽	nftm
鯕	nftmc
鮮	nftq
鱹	nftrg
鱔	nfttr
鰽	nftwa
鱒	nftwi
鱴	nftwi
鱧	nftwt
鰜	nftxc
鱳	nfvid
鯔	nfvvw
鯉	nfwg
魻	nfwl
鰅	nfwlb
鰥	nfwle
鰥	nfwlo
鱞	nfwlv
鮂	nfwo
鰓	nfwp
鮫	nfyck
魧	nfyhn
魴	nfyhs
鰱	nfyjj
魰	nfyk
鮛	nfymf
鱁	nfymo
鰬	nfypk
鱋	nfypm
鱸	nfypt
鰝	nfyrb
鯙	nfyrd
鯨	nfyrf
鱆	nfytj
鯜	nfytv
鱣	nfywm
鱭	nfyx
丑	ng
頲	ngmbc
疆	ngmwm
矞	nhbcr
柔	nhd
及	nhe
務	nhhes
虱	nhli
蟊	nhlii
矜	nhoin
務	nhoks
弤	nhpm
乃	nhs
騭	nhsqf
矠	nhta
弧	nhvo
夕	ni
弘	ni
甬	nibq
鵵	nihaf
夤	nijmc
強	nili
劖	niln
矛	ninh
多	nini
酁	ninl
予	ninn
飧	nioiv
舛	niq
名	nir
夗	nisu
外	niy
謽	niymr
癶	niyo
鳵	njhaf
蝨	njlii
又	nk
瞀	nkbu
鍪	nkc
楘	nkd
煞	nkf
堥	nkg
迫	nkha
鶩	nkhaf
廷	nkhg
延	nkhym
戣	nki
蝥	nklmi
建	nklq
鄈	nknl
騖	nksqf
鞪	nktlj
婺	nkv
迴	nkwr
引	nl
弔	nl
陽	nlamh
隄	nlamo
限	nlav
隰	nlavf
阻	nlbm
隱	nlbmp
際	nlbof
盄	nlbt
陂	nldhe
陳	nldw
敶	nldwk
鄰	nlfdq
隙	nlfhf
陵	nlgce
陸	nlgcg
隢	nlggu
阹	nlgi
隞	nlgsk
陡	nlgyo
隍	nlhag
隩	nlhbk
阪	nlhe
隆	nlhem
降	nlheq
阡	nlhj
陎	nlhjd
隀	nlhjg
陲	nlhjm
阺	nlhpm
陞	nlhtg
隗	nlhui
陴	nlhwj
隉	nlhxg
阭	nlihu
隇	nlihv
陼	nljka
院	nljmu
陀	nljp
陣	nljwj
陏	nlkb
隋	nlkmb
隓	nlkmm
陭	nlkmr
陓	nlkms
陝	nlkoo
阞	nlks
隤	nllmc
陫	nllmy
陌	nlma
陾	nlmbk
陑	nlmbl
陋	nlmbv
隬	nlmfb
阮	nlmmu
阿	nlmnr
陃	nlmob
隔	nlmrb
阨	nlmsu
阢	nlmu
陘	nlmvm
陷	nlnhx
陊	nlnin
阠	nlnj
附	nlodi
陰	nloii
隆	nlokm
陯	nlomb
除	nlomd
隃	nlomn
險	nlomo
隃	nlomv
阣	nlon
阼	nlos
阤	nlpd
陱	nlpfd
陶	nlpou
阰	nlpp
階	nlppa
陛	nlppg
隕	nlrbc
陷	nlshx
陬	nlsje
隘	nltct
隊	nltpo
阱	nltt
隒	nltxc
隑	nlumt
隅	nlwlb
隈	nlwmv
隴	nlybp
隡	nlyhm
阬	nlyhn
防	nlyhs
隨	nlykb
隡	nlykm
陟	nlylh
阯	nlylm
阽	nlyr
障	nlytj
隧	nlyto
陪	nlytr
陔	nlyvo
隮	nlyx
弼	nman
檃	nmd
疏	nmdl
彌	nmfb
蜑	nmlmi
彐	nmm
弱	nmnim
郔	nmnl
鶸	nmnmf
急	nmp
危	nmsu
弳	nmvm
彊	nmwm
疏	nmyiu
了	nn
廴	nnk
孑	nnm
預	nnmbc
鬻	nnmrb
豫	nnnao
孓	nno
夠	nnpr
承	nnqo
翗	nnsmm
郺	nnvvu
欠	no
久	no
胥	nob
鐆	noc
弣	nodi
灸	nof
墜	nog
癹	nohne
飛	nohto
蛋	nolmi
癸	nomk
登	nomrt
發	nonhe
弛	npd
丮	nq
桀	nqd
蟹	nqlmi
強	nrli
甔	nrmvn
毚	nrppi
彈	nrrj
盈	nsbt
鼐	nsbul
爭	nsd
尕	nsf
夃	nshe
弨	nshr
弭	nsj
張	nsmv
孕	nsnd
急	nsp
彄	nsrr
凳	nthn
戤	nti
彉	ntlc
鄧	ntnl
乙	nu
眢	nubu
弢	nue
鴛	nuhaf
勉	nuks
頠	numbc
怨	nup
駌	nusqf
妴	nuv
魚	nwf
魯	nwfa
螴	nwlmi
彋	nwlv
彃	nwtj
卍	nx
燄	nxff
欿	nxno
龜	nxu
疋	nyo
弶	nyrf
弦	nyvi
人	o
倡	oaa
复	oahe
劊	oaln
但	oam
偍	oamo
們	oan
僩	oanb
鄶	oanl
倱	oapp
偈	oapv
傝	oasm
儤	oate
佷	oav
儑	oavf
僈	oawe
內	ob
仴	ob
俷	obau
倗	obb
僾	obbe
儩	obch
側	obcn
偁	obgb
倜	obgr
鸙	obhaf
龢	obhd
偽	obhf
伔	obhu
俱	obmc
侗	obmr
俘	obnd
肉	obo
傺	obof
傜	obou
憊	obp
龤	obppa
佣	obq
倜	obqr
俔	obuu
俀	obv
傒	obvk
仈	oc
佾	ocb
伀	oci
俗	ocor
侻	ocru
份	ocsh
僧	ocwa
休	od
鎥	odc
倯	odci
僸	oddf
儊	oddo
敘	ode
煲	odf
烋	odf
堡	odg
鵂	odhf
付	odi
体	odm
偉	odmq
雓	odog
敘	odok
怹	odp
糴	odsmg
敘	odye
斜	odyj
汆	oe
伙	of
尒	of
俏	ofb
償	ofbc
儻	ofbf
倘	ofbr
儅	ofbw
僯	ofdq
倓	off
僗	offs
鷦	ofhaf
鷡	ofhaf
偗	ofhu
劁	ofln
甒	ofmvn
鄦	ofnl
您	ofp
伴	ofq
倦	ofqu
仕	og
隹	og
賃	ogbuc
倰	ogce
集	ogd
栠	ogd
侍	ogdi
雙	oge
隻	oge
焦	ogf
佳	ogg
僥	oggu
鶴	oghaf
鵀	oghaf
犨	oghq
佉	ogi
隼	ogj
雋	oglms
剉	ogln
儔	ogni
雔	ogog
雥	ogogg
恁	ogp
售	ogr
佶	ogr
儓	ogrg
僖	ogrr
傲	ogsk
倖	ogtj
儥	ogwc
讎	ogymr
讎	ogyrg
入	oh
伯	oha
偟	ohag
侐	ohbt
侜	ohby
傻	ohce
偢	ohdf
俬	ohdi
俐	ohdn
僁	ohdp
倭	ohdv
僠	ohdw
佫	oher
佟	ohey
僽	ohfp
任	ohg
侁	ohgu
仟	ohj
侏	ohjd
偅	ohjg
倕	ohjm
佸	ohjr
偛	ohjx
僑	ohkb
偊	ohlb
伒	ohml
仉	ohn
佩	ohnb
偑	ohni
偺	ohoa
偫	ohoi
傱	ohoo
低	ohpm
件	ohq
俄	ohqi
佚	ohqo
偏	ohsb
僱	ohsg
儌	ohsk
儹	ohuc
傀	ohui
係	ohvf
仰	ohvl
俾	ohwj
傯	ohwp
倪	ohxu
傂	ohyu
伐	oi
餳	oiamh
餛	oiapp
餲	oiapv
倉	oiar
食	oiav
俍	oiav
饅	oiawe
傅	oibi
餫	oibjj
餇	oibmr
餒	oibv
俊	oice
餩	oicyo
餗	oidl
餟	oieee
饓	oifbd
餤	oiff
饐	oigbt
饒	oiggu
饁	oigit
饎	oigrr
鴒	oihaf
餭	oihag
餉	oihbr
餧	oihdv
飯	oihe
傶	oihf
飪	oihg
飹	oihhl
餾	oihhw
餂	oihjr
飫	oihk
飢	oihn
餰	oihon
飥	oihp
侂	oihp
侔	oihq
餓	oihqi
饡	oihuc
餽	oihui
餿	oihxe
俴	oii
餺	oiibi
餕	oiice
餞	oiii
餔	oiijb
飴	oiir
餑	oijbd
俅	oije
餬	oijrb
館	oijrr
饙	oijtc
伏	oik
偽	oikf
餚	oikkb
优	oiku
傭	oilb
饋	oilmc
蝕	oilmi
韱	oilsm
領	oimbc
餪	oimbk
餂	oimjr
飣	oimn
佽	oimo
餖	oimrt
瓴	oimvn
今	oin
貪	oinc
餡	oinhx
令	oini
飲	oino
念	oinp
含	oinr
饞	oinri
盦	oint
衾	oinv
酓	oinw
俯	oioi
俟	oiok
飭	oioks
飾	oiolb
餘	oiomd
餼	oiond
餱	oionk
代	oip
怤	oip
儦	oipf
飶	oiph
飽	oipru
飩	oipu
佁	oir
饌	oiruc
餌	oisj
翎	oismm
飼	oismr
饇	oisrr
饃	oitak
饛	oitbo
餀	oitk
饉	oitlm
饈	oitqg
餅	oitt
姇	oiv
饑	oivii
餯	oivno
餵	oiwmv
餃	oiyck
饖	oiymh
饟	oiyrv
饘	oiywm
什	oj
午	oj
伂	ojb
傎	ojbc
值	ojbm
倥	ojcm
傛	ojcr
伎	oje
侘	ojhp
傳	ojii
仗	ojk
佬	ojkp
使	ojlk
倳	ojln
倢	ojlo
儐	ojmc
倧	ojmf
啎	ojmmr
佇	ojmn
傢	ojmo
倇	ojnu
佗	ojp
儜	ojpn
估	ojr
做	ojrk
倌	ojrr
僨	ojtc
僿	ojtg
缶	oju
侒	ojv
矢	ok
侑	okb
僚	okcf
矰	okcwa
焂	okf
瀪	okhae
鴙	okhaf
矮	okhdv
俇	okhg
矨	okhk
矯	okhkb
俙	okkb
傸	okkk
佈	oklb
俺	oklu
佐	okm
倷	okmf
倚	okmr
短	okmrt
侉	okms
仇	okn
侇	okn
矧	oknl
雉	okog
俠	okoo
矬	okoog
悠	okp
知	okr
佑	okr
跾	okryo
仂	oks
伽	oksr
矩	okss
矱	oktoe
繁	okvif
矲	okwlp
仲	ol
佒	olbk
介	oll
佛	olln
僂	ollv
僓	olmc
佻	olmo
儘	olmt
俳	olmy
候	olnk
脩	olob
條	olod
絛	olof
鯈	olof
修	oloh
鞗	oloj
攸	olok
倏	olok
翛	olom
偝	olpb
伸	olwl
俜	olws
丘	om
仝	om
仜	om
佰	oma
儒	ombb
優	ombe
侕	ombl
俞	ombn
愈	ombp
侖	ombt
兵	omc
余	omd
伍	omdm
悆	omdp
峹	omdu
嵞	omdu
畬	omdw
伓	omf
伻	omfj
伾	omfm
俖	omfr
全	omg
倒	omgn
乒	omh
儮	omhm
乓	omi
侄	omig
舍	omjr
倆	omlb
便	omlk
仁	omm
佘	ommf
伝	ommi
仨	ommm
佽	ommo
儷	ommp
俉	ommr
佞	ommv
侲	ommv
仃	omn
气	omn
邱	omnl
例	omnn
歙	omno
何	omnr
倵	ompm
合	omr
龠	omrb
命	omrl
僉	omro
偪	omrw
卸	omsl
屔	omsp
侀	omtn
岳	omu
僭	omua
伢	omvh
俓	omvm
佤	omvn
會	omwa
價	omwc
僳	omwd
僄	omwf
偭	omwl
僵	omwm
僊	omwu
偠	omwv
傿	omyf
乞	on
氳	onabt
像	onao
俛	onau
偩	onbc
覦	onbuu
儋	oncr
氛	oncsh
仔	ond
你	onf
氣	onfd
氮	onff
鳹	onhaf
僪	onhb
伋	onhe
氡	onhey
毹	onhqu
仍	onhs
俑	onib
侈	onin
伃	onin
氪	onjru
氨	onjv
侹	onkg
鄇	onkl
健	onkq
氕	onl
伄	onl
氘	onll
氚	onlll
氟	onlln
刉	onln
氠	onlwl
氥	onmcw
侯	onmk
氬	onmlm
佹	onmu
氫	onmvm
氖	onnhs
鄃	onnl
歈	onno
氝	onob
雂	onog
忥	onp
傑	onqd
氰	onqmb
儳	onri
氧	ontq
氙	onu
氯	onvne
氤	onwk
氳	onwot
氦	onyvo
從	oo
傷	ooah
傕	oobg
俎	oobm
肏	oobo
坐	oog
倠	oog
夎	ooge
僬	oogf
僋	ooic
伶	ooii
仱	ooin
傖	ooir
仵	ooj
价	ooll
劍	ooln
儈	ooma
倫	oomb
顩	oombc
佺	oomg
偷	oomn
儉	oomo
佮	oomr
仡	oon
歛	oono
眾	ooo
侳	ooog
傘	oooj
斂	oook
作	oos
佡	oou
侮	oowy
化	op
伈	op
侚	opa
貨	opbuc
貸	opbuc
他	opd
柋	opd
佖	oph
牮	ophq
儗	opko
傯	opkp
傾	opmc
敜	opok
仳	opp
偕	oppa
佝	opr
伳	opt
偞	optd
岱	opu
伅	opu
黛	opwgf
袋	opyhv
年	oq
偰	oqhk
偆	oqka
傣	oqke
俸	oqkq
倩	oqmb
債	oqmc
傃	oqmf
俵	oqmv
伕	oqo
僣	oqoa
智	ora
俋	orau
盒	orbt
伿	orc
保	ord
樖	ordmr
鴿	orhaf
鶬	orhaf
鵨	orhaf
侶	orhr
侃	orhu
戧	ori
舖	orijb
館	orjrr
創	orln
頜	ormbc
頷	ormbc
舒	ornin
郃	ornl
欱	orno
拿	orq
僤	orrj
儼	orrk
假	orse
偮	orsj
翕	orsmm
弇	ort
僎	oruc
俁	orvk
畣	orw
僶	orxu
龕	orybp
敆	orye
促	oryo
乍	os
偃	osav
矱	osd
仞	oshi
佴	osj
倨	osjr
伊	osk
侵	osme
偓	osmg
僇	osmh
伺	osmr
倀	osmv
僝	osnd
伬	oso
怎	osp
傌	osqf
僻	osrj
傴	osrr
佢	oss
侷	ossr
偋	ostt
倔	osuu
借	ota
倎	otbc
供	otc
僕	otco
僛	otco
偤	otcw
橆	otdd
無	otf
儀	otgi
備	othb
儰	otif
偌	otkr
偀	otlk
僅	otlm
倛	otmc
偡	otmv
舞	otniq
儺	otog
佯	otq
傞	otqm
儆	otrk
傇	otsj
併	ott
傋	ottb
傮	otwa
僔	otwi
儚	otwn
儂	otwv
傔	otxc
仙	ou
仚	ou
屳	ou
罈	ouami
傰	oubb
傻	ouce
缺	oudk
缽	oudm
缹	ouf
缿	ouhmr
缸	oum
偳	oumb
罈	oumwj
催	ouog
侺	ouon
罐	outrg
缾	outt
缾	ouyjj
罅	ouypd
罏	ouypt
覦	ovbuu
似	ovio
侞	ovr
儠	ovvv
佃	ow
俚	owg
個	owjr
偶	owlb
儸	owlg
儇	owlv
偎	owmv
偲	owp
佪	owr
儽	owwf
儡	owww
每	owyi
韽	owyta
仆	oy
倬	oyaj
偵	oybc
儱	oybp
傍	oybs
佼	oyck
儭	oydu
俶	oyfe
僦	oyfu
住	oyg
伉	oyhn
仿	oyhs
依	oyhv
僆	oyjj
傚	oykk
企	oylm
仩	oym
佌	oymp
信	oymr
佧	oymy
倅	oyoj
敏	oyok
偨	oypd
儢	oypp
佔	oyr
儲	oyra
倞	oyrf
停	oyrn
儴	oyrv
偯	oyrv
倣	oysk
位	oyt
偣	oyta
僮	oytg
傽	oytj
億	oytp
倍	oytr
禽	oyub
伭	oyvi
侅	oyvo
儃	oywm
儕	oyx
毓	oyyiu
心	p
旬	pa
旨	pa
慍	pabt
鶛	pahaf
惺	pahm
慨	paiu
勓	paks
怛	pam
愓	pamh
悍	pamj
惿	pamo
憪	panb
憫	pank
郇	panl
惕	paph
惃	papp
愒	papv
懪	pate
恨	pav
慢	pawe
憬	payf
慏	pbac
愲	pbbb
惻	pbcn
墯	pbg
惆	pbgr
慆	pbhx
惲	pbjj
怚	pbm
愋	pbme
恫	pbmr
愮	pbou
惘	pbtv
戄	pbue
懼	pbug
慀	pbvk
惍	pc
忪	pci
勩	pcks
悌	pcnh
悅	pcru
憎	pcwa
也	pd
惏	pdd
鵴	pdhaf
忖	pdi
快	pdk
悚	pdl
懶	pdlc
穎	pdmbc
惙	peee
怪	peg
慅	peii
潁	pembc
悄	pfb
戃	pfbf
惝	pfbr
匊	pfd
憐	pfdq
惔	pff
穎	pfmbc
熲	pfmbc
顈	pfmbc
恍	pfmu
怑	pfq
惓	pfqu
恃	pgdi
憢	pggu
怯	pgi
懤	pgni
恄	pgr
憉	pgth
悻	pgtj
必	ph
怕	pha
曶	pha
惶	phag
懊	phbk
甮	phbq
恦	phbr
恤	phbt
覕	phbuu
懰	phcn
憡	phdb
悸	phdd
愀	phdf
恪	pher
悎	phgr
慟	phgs
勿	phh
匑	phhn
忏	phj
恬	phjr
憍	phkb
悿	phkp
懫	phlc
刎	phln
忻	phml
邲	phnl
忽	php
惛	phpa
性	phqm
怢	phqo
惼	phsb
憿	phsk
悷	phsk
愧	phui
忯	phvp
袃	phyhv
勾	pi
勺	pi
悢	piav
悛	pice
怵	pid
慘	piih
匍	pijb
怵	pijc
慵	pilb
慷	pile
勻	pim
怡	pir
憾	pirp
悈	pit
懭	pitc
怴	piv
惦	piyr
慎	pjbc
悖	pjbd
懥	pjbo
悾	pjcm
忮	pje
鴇	pjhaf
愘	pjhr
慱	pjii
憓	pjip
慚	pjjl
恅	pjkp
悽	pjlv
悰	pjmf
愃	pjmm
惋	pjnu
懧	pjpn
怙	pjr
悺	pjrr
駂	pjsqf
憤	pjtc
忕	pk
憭	pkcf
恢	pkf
匆	pkk
悕	pkkb
慡	pkkk
怖	pklb
肄	pklq
匎	pklu
惰	pkmb
恞	pkn
勼	pkn
疑	pknio
匆	pkp
愶	pksb
協	pkss
忡	pl
怏	plbk
忱	plbu
怫	plln
慺	pllv
憒	plmc
恌	plmo
悱	plmy
懻	plpc
怞	plw
懨	pmak
恒	pmam
懦	pmbb
頃	pmbc
愩	pmbc
懮	pmbe
恆	pmbm
恓	pmcw
怀	pmf
怦	pmfj
匉	pmfj
怌	pmfm
恬	pmjr
勻	pmm
悟	pmmr
忨	pmmu
怲	pmob
匐	pmrw
愊	pmrw
憯	pmua
慄	pmwd
憟	pmwd
慓	pmwf
憛	pmwj
愐	pmwl
怔	pmym
乜	pn
悗	pnau
懈	pnbq
憺	pncr
忸	png
憰	pnhb
忣	pnhe
悀	pnib
恀	pnin
忺	pno
惤	pnyi
愎	poae
恘	pod
惟	pog
愯	poge
憔	pogf
怜	poii
懺	poim
忴	poin
愴	poir
忤	poj
匋	poju
惀	pomb
悇	pomd
恮	pomg
愉	pomn
憸	pomo
恰	pomr
忔	pon
觺	ponbg
愾	pond
怍	pos
憮	potf
悔	powy
比	pp
恂	ppa
恉	ppa
惸	ppad
粊	ppfd
坒	ppg
怭	pph
皆	ppha
惚	pphp
毞	pphqu
惢	ppp
橤	pppd
繠	pppf
毖	ppph
怐	ppr
怉	ppru
惵	pptd
忳	ppu
恟	ppuk
情	pqmb
愫	pqmf
句	pr
悒	prau
悁	prb
鴝	prhaf
悜	prhg
斪	prhml
怳	prhu
劬	prks
夠	prnin
欨	prno
雊	prog
懆	prrd
憚	prrj
愕	prrs
包	pru
怋	prvp
憴	prxu
愝	psav
慳	pseg
切	psh
忉	psh
怊	pshr
懾	psjj
愜	psko
慴	psma
恇	psmg
憀	psmh
憳	psmi
悵	psmv
怩	psp
慪	psrr
世	pt
惜	pta
慔	ptak
懞	ptbo
貰	ptbuc
懂	pthg
慲	ptlb
愅	ptlj
慬	ptlm
愖	ptmv
匒	ptor
懩	ptov
懽	ptrg
恲	ptt
慒	ptwa
懱	ptwi
懵	ptwu
慊	ptxc
慌	ptyu
屯	pu
惾	puce
皺	pudhe
炰	puf
鶵	puhaf
匈	puk
忷	puk
刨	puln
惴	pumb
頓	pumbc
愷	pumt
鄒	punl
雛	puog
慛	puog
芻	pupu
怓	pve
怮	pvis
惱	pvvw
甸	pw
怬	pwc
惈	pwd
悃	pwd
悝	pwg
慖	pwim
慣	pwjc
懌	pwlj
愣	pwls
懁	pwlv
愄	pwmv
慍	pwot
恛	pwr
悼	pyaj
恔	pyck
憱	pyfu
慥	pyhr
訇	pymr
悴	pyoj
懅	pypo
怗	pyr
惇	pyrd
惊	pyrf
懹	pyrv
愔	pyta
憧	pytg
慞	pytj
憶	pytp
忙	pyv
慉	pyvw
懍	pywd
懷	pywv
懠	pyx
忭	pyy
手	q
抇	qa
搵	qabt
揤	qail
摡	qaiu
蠢	qalii
擔	qam
揚	qamh
捍	qamj
提	qamo
捫	qan
撊	qanb
撋	qang
擱	qanr
攔	qanw
惷	qap
掍	qapp
揭	qapv
撮	qase
搨	qasm
把	qau
拫	qav
捑	qavk
抈	qb
掤	qbb
搰	qbbb
授	qbbe
靜	qbbsd
靚	qbbuu
探	qbcd
攖	qbcv
採	qbd
捋	qbdi
鶄	qbhaf
撝	qbhf
搯	qbhx
揮	qbjj
靛	qbjmo
撚	qbkf
抯	qbm
援	qbme
挏	qbmr
靘	qbnau
捊	qbnd
郬	qbnl
搖	qbou
掙	qbsd
攫	qbue
挸	qbuu
挼	qbv
扒	qc
掰	qchq
勣	qcks
撳	qcno
挩	qcru
扮	qcsh
耒	qd
耙	qdau
拺	qdb
耡	qdbms
耖	qdfh
披	qdhe
耗	qdhqu
耛	qdir
抹	qdj
抉	qdk
耞	qdksr
耬	qdllv
頛	qdmbc
耰	qdmbe
耘	qdmmi
耨	qdmvi
耔	qdnd
耜	qdrlr
耟	qdss
耤	qdta
耕	qdtt
耩	qdttb
揀	qdwf
耦	qdwlb
耪	qdybs
搡	qeed
掇	qeee
扠	qei
搔	qeii
捎	qfb
攩	qfbf
撐	qfbh
撇	qfbk
撐	qfbq
擋	qfbw
掞	qff
撈	qffs
抄	qfh
拌	qfq
捲	qfqu
抩	qgb
持	qgdi
挂	qgg
撓	qggu
掛	qggy
抾	qgi
搕	qgit
捇	qglc
擣	qgni
拮	qgr
擷	qgrc
抬	qgrg
拍	qha
揘	qhag
擳	qhal
搗	qhau
攥	qhbf
擙	qhbk
攪	qhbu
栔	qhd
揪	qhdf
捼	qhdv
播	qhdw
扳	qhe
洯	qhe
捀	qhej
挌	qher
捁	qhgr
挀	qhhv
抸	qhio
扦	qhj
揰	qhjg
捶	qhjm
括	qhjr
揗	qhju
插	qhjx
契	qhk
扷	qhk
撟	qhkb
掭	qhkp
蛪	qhlmi
掀	qhlo
抓	qhlo
折	qhml
拆	qhmy
觢	qhnbg
投	qhne
揝	qhoa
摐	qhoo
撘	qhor
托	qhp
恝	qhp
抵	qhpm
挈	qhq
抶	qhqo
摀	qhrf
掮	qhsb
揙	qhsb
撽	qhsk
捩	qhsk
搧	qhsm
攢	qhuc
擤	qhul
擨	qhuo
擤	qhut
撬	qhuu
絜	qhvif
抑	qhvl
扺	qhvp
捭	qhwj
摠	qhwp
搜	qhxe
捏	qhxg
捏	qhxm
掜	qhxu
搬	qhye
齧	qhymu
搋	qhyu
找	qi
搏	qibi
捘	qice
攠	qicy
攠	qidy
摵	qihf
搣	qihf
抁	qihu
摻	qiih
捕	qijb
捄	qije
拔	qike
撝	qikf
拔	qikk
扰	qiku
搪	qilr
挨	qiok
攗	qipd
拭	qipm
抬	qir
掝	qirm
撼	qirp
拚	qit
擴	qitc
摭	qitf
摝	qixp
掂	qiyr
丰	qj
搷	qjbc
挬	qjbd
擦	qjbf
揇	qjbj
攮	qjbv
控	qjcm
挖	qjcn
搾	qjcs
攛	qjcv
技	qje
挓	qjhp
抭	qjhu
摶	qjii
撠	qjji
搟	qjjj
摲	qjjl
扙	qjk
拷	qjks
捷	qjlo
擯	qjmc
揎	qjmm
掟	qjmo
砉	qjmr
捖	qjmu
邦	qjnl
鄻	qjnl
捥	qjnu
摍	qjoa
搘	qjpa
擰	qjpn
攇	qjqp
搳	qjqr
彗	qjsm
慧	qjsmp
攓	qjto
攐	qjtv
按	qjv
捙	qjwj
春	qka
摋	qkce
撩	qkcf
泰	qke
拻	qkf
秦	qkhd
奏	qkhk
舂	qkhx
撦	qkja
抪	qklb
拵	qkld
掩	qklu
捺	qkmf
掎	qkmr
挎	qkms
拋	qkns
挾	qkoo
奉	qkq
扐	qks
搚	qksb
摦	qkso
拹	qkss
拋	qkus
晢	qla
抰	qlbk
抌	qlbu
銴	qlc
捸	qle
焎	qlf
蜇	qllmi
拂	qlln
摟	qllv
撌	qlmc
挑	qlmo
硩	qlmr
排	qlmy
悊	qlp
揹	qlpb
哲	qlr
踅	qlryo
擻	qlvk
抽	qlw
抻	qlwl
拽	qlwp
裚	qlyhv
誓	qlymr
扛	qm
擫	qmak
青	qmb
擩	qmbb
摃	qmbc
擾	qmbe
攉	qmbg
摴	qmbs
責	qmbuc
擂	qmbw
扜	qmd
抔	qmf
抨	qmfj
捱	qmgg
捯	qmgn
搢	qmia
挃	qmig
扞	qmj
撖	qmjk
括	qmjr
插	qmjx
挭	qmlk
掗	qmlm
抎	qmmi
攦	qmmp
捂	qmmr
抏	qmmu
振	qmmv
打	qmn
拓	qmr
搹	qmrb
揊	qmrw
扼	qmsu
撅	qmto
扤	qmu
表	qmv
素	qmvif
挳	qmvm
搮	qmwd
摽	qmwf
撢	qmwj
纛	qmwyf
毒	qmwyi
挽	qnau
捔	qnbg
換	qnbk
擔	qncr
搎	qndf
拯	qnem
扭	qng
揉	qnhd
扱	qnhe
扔	qnhs
掐	qnhx
捅	qnib
抒	qnin
拸	qnin
挺	qnkg
挻	qnkm
揵	qnkq
撱	qnlb
搦	qnmm
扻	qno
揟	qnob
撥	qnoe
揆	qnok
撜	qnot
攙	qnri
擼	qnwa
夫	qo
替	qoa
摥	qoah
搉	qobg
規	qobuu
拊	qodi
推	qog
鳺	qohaf
拰	qohg
抮	qohh
拎	qoii
攕	qoim
扲	qoin
捻	qoip
搶	qoir
輦	qojwj
扴	qoll
掄	qomb
捈	qomd
拴	qomg
揄	qomn
撿	qomo
拾	qomr
捨	qomr
扢	qon
邞	qonl
挫	qoog
拖	qopd
搿	qorq
揜	qort
撫	qotf
挴	qowy
摿	qoya
擒	qoyb
指	qpa
扡	qpd
掬	qpfd
扚	qpi
擬	qpko
揯	qpmm
掏	qpou
批	qpp
揩	qppa
拘	qpr
抱	qpru
抴	qpt
揲	qptd
扽	qpu
搊	qpuu
揈	qpyr
揳	qqhk
揍	qqkk
捧	qqkq
掅	qqmb
扶	qqo
攆	qqoj
摫	qqou
掱	qqq
扥	qqu
扣	qr
挹	qrau
捐	qrb
損	qrbc
拐	qrks
操	qrrd
撣	qrrj
拐	qrsh
揖	qrsj
捌	qrsn
撰	qruc
抿	qrvp
捉	qryo
揠	qsav
摨	qseq
招	qshr
掐	qshx
挕	qsj
掫	qsje
攝	qsjj
揶	qsjl
据	qsjr
捃	qskr
挋	qsll
摺	qsma
掃	qsmb
握	qsmg
擢	qsmg
摎	qsmh
撏	qsmi
掁	qsmv
抳	qsp
挪	qsql
擗	qsrj
摳	qsrr
拒	qss
挶	qssr
摒	qstt
搌	qstv
掘	qsuu
攬	qswu
摒	qsyj
措	qta
摸	qtak
擖	qtav
捵	qtbc
攃	qtbf
撒	qtbk
揃	qtbn
拱	qtc
撕	qtcl
撲	qtco
搤	qtct
揂	qtcw
擲	qtkl
撗	qtlc
拑	qtm
掑	qtmc
揕	qtmv
搽	qtod
擭	qtoe
攤	qtog
搭	qtor
攁	qtov
擛	qtpd
搓	qtqm
擏	qtrk
拼	qtt
搆	qttb
掽	qttc
搠	qtub
描	qtw
撙	qtwi
擃	qtwv
搛	qtxc
扎	qu
槼	qud
揣	qumb
攜	quob
摧	quog
拙	quu
嫢	quv
紮	quvif
擽	qvid
拗	qvis
掾	qvno
攭	qvoi
摷	qvvd
拶	qvvn
擸	qvvv
捆	qwd
捰	qwd
捚	qwg
撂	qwhr
摑	qwim
摜	qwjc
摁	qwkp
押	qwl
擉	qwli
擇	qwlj
擺	qwlp
擐	qwlv
揋	qwmv
搵	qwot
揌	qwp
摞	qwvf
攌	qwwv
拇	qwyi
憃	qxp
扑	qy
掉	qyaj
揥	qybb
撾	qybb
攡	qybg
撤	qybk
攏	qybp
搒	qybs
摘	qycb
挍	qyck
拄	qyg
撻	qygq
摓	qyhj
抗	qyhn
搥	qyhr
挔	qyhv
摔	qyij
抖	qyj
拼	qyjj
摙	qyjj
抆	qyk
捗	qylh
扯	qylm
掯	qymb
攍	qynv
捽	qyoj
掖	qyok
據	qypo
攄	qypp
擄	qyps
攎	qypt
拈	qyr
搞	qyrb
掠	qyrf
揨	qyrn
攘	qyrv
揓	qysd
拉	qyt
撞	qytg
掊	qytr
摬	qytu
接	qytv
摛	qyub
擁	qyvg
搐	qyvw
擅	qywm
擠	qyx
抃	qyy
擿	qyyb
口	r
唱	raa
唧	rail
呾	ram
哻	ramj
嚪	ranx
喝	rapv
嘬	rase
嚗	rate
吧	rau
邑	rau
哏	rav
敯	raye
肙	rb
噯	rbbe
喎	rbbr
嚶	rbcv
啋	rbd
哷	rbdi
啁	rbgr
鵑	rbhaf
咀	rbm
哃	rbmr
嗂	rbou
嗣	rbsmr
員	rbuc
唄	rbuc
哸	rbv
嚼	rbwi
只	rc
叭	rc
嗡	rcim
嗲	rckn
勛	rcks
鄖	rcnl
吩	rcsh
噌	rcwa
呆	rd
喳	rdam
噤	rddf
氉	rdhqu
吋	rdi
吷	rdk
喇	rdln
劋	rdln
嗽	rdlo
呠	rdm
喡	rdmq
鄵	rdnl
唻	rdoo
啵	rede
嗓	reed
啜	reee
唦	refh
嗨	reoy
吙	rf
哨	rfb
嚐	rfba
嗩	rfbc
噹	rfbw
咪	rfd
啖	rff
嘮	rffs
吵	rfh
吐	rg
呥	rgb
噎	rgbt
嚇	rgcc
哇	rgg
嘵	rggu
鷕	rghaf
呿	rgi
嗑	rgit
嚽	rgkc
哧	rglc
郢	rgnl
咭	rgr
嘻	rgrr
嗷	rgsk
啈	rgtj
唗	rgyo
嘄	rhad
鳴	rhaf
喤	rhag
嗥	rhaj
噢	rhbk
響	rhbr
咱	rhbu
啾	rhdf
唎	rhdn
咯	rher
咚	rhey
呼	rhfd
呈	rhg
哠	rhgr
嚟	rhhe
吆	rhi
咮	rhjd
唾	rhjm
咶	rhjr
喢	rhjx
嘺	rhkb
听	rhml
噬	rhmo
喒	rhoa
吒	rhp
呧	rhpm
吽	rhq
哦	rhqi
呂	rhr
嗚	rhrf
噭	rhsk
唳	rhsk
呏	rht
兄	rhu
囋	rhuc
嗅	rhuk
呱	rhvo
啤	rhwj
嗖	rhxe
唲	rhxu
唆	rice
嘛	ridd
嘁	rihf
哞	rihq
喊	rihr
吮	rihu
啷	riil
哺	rijb
嘛	rijc
吠	rik
噅	rikf
詠	rine
雖	riog
唉	riok
咍	rir
嚝	ritc
喥	rite
哤	riuh
嘟	rjal
嗔	rjbc
哱	rjbd
嗦	rjbf
嚓	rjbf
喃	rjbj
嚏	rjbo
囔	rjbv
噾	rjca
味	rjd
吱	rje
鷤	rjhaf
吒	rjhp
喀	rjhr
戰	rji
戢	rji
嘲	rjjb
囀	rjji
哮	rjkd
咾	rjkp
啑	rjlo
喧	rjmm
辴	rjmmv
啶	rjmo
鄲	rjnl
嘜	rjon
嗜	rjpa
嚀	rjpn
嘧	rjpu
嗐	rjqr
咕	rjr
囅	rjstv
噴	rjtc
暋	rka
睯	rkbu
嘹	rkcf
吰	rki
呔	rki
唏	rkkb
咘	rklb
唵	rklu
咦	rkn
唊	rkoo
愍	rkp
另	rks
叻	rks
嗋	rksb
咖	rksr
吊	rlb
咈	rlln
嘍	rllv
嘳	rlmc
咷	rlmo
嚍	rlmt
啡	rlmy
呻	rlwl
嘯	rlx
咺	rmam
踼	rmamh
踶	rmamo
躝	rmanw
踢	rmaph
蹋	rmasm
跁	rmau
跟	rmav
嚅	rmbb
跚	rmbbm
嗊	rmbc
踩	rmbd
嚘	rmbe
蹈	rmbhx
跙	rmbm
跚	rmbt
躩	rmbue
躣	rmbug
蹊	rmbvk
趴	rmc
哂	rmcw
唒	rmcw
蹭	rmcwa
吁	rmd
蹅	rmdam
跛	rmdhe
趹	rmdk
踏	rmea
吥	rmf
踃	rmfb
蹚	rmfbg
蹐	rmfcb
蹸	rmfdq
躞	rmffe
呯	rmfj
呸	rmfm
跘	rmfq
踡	rmfqu
呈	rmg
踜	rmgce
踛	rmgcg
跱	rmgdi
跬	rmgg
啀	rmgg
蹺	rmggu
躊	rmgni
哢	rmgt
跿	rmgyo
踿	rmhdf
踒	rmhdv
蹯	rmhdw
路	rmher
跣	rmhgu
蹓	rmhhw
跦	rmhjd
踵	rmhjg
蹻	rmhkb
踽	rmhlb
躓	rmhlc
嚦	rmhm
斲	rmhml
跅	rmhmy
跺	rmhnd
蹤	rmhoo
蹝	rmhoo
跌	rmhqo
蹁	rmhsb
躈	rmhsk
躦	rmhuc
踉	rmiav
踆	rmice
咥	rmig
躕	rmigi
踐	rmii
跋	rmikk
跆	rmir
踱	rmite
蹠	rmitf
躔	rmiwg
蹗	rmixp
踮	rmiyr
蹎	rmjbc
躥	rmjcv
跂	rmje
噉	rmjk
踍	rmjkd
踕	rmjlo
蹤	rmjmf
踠	rmjnu
蹜	rmjoa
跎	rmjp
跍	rmjr
踦	rmkmr
跨	rmkms
跠	rmkn
蹛	rmkpb
跏	rmksr
啢	rmlb
哽	rmlk
啞	rmlm
蹪	rmlmc
跳	rmlmo
跩	rmlwp
跴	rmmcw
趶	rmmd
躎	rmmfb
躕	rmmgi
跮	rmmig
趼	rmmjj
噁	rmmp
跖	rmmr
唔	rmmr
踾	rmmrw
趼	rmmt
蹶	rmmto
叮	rmn
踴	rmnbs
蹂	rmnhd
趿	rmnhe
踊	rmnib
跢	rmnin
跪	rmnmu
咧	rmnn
蹳	rmnoe
蹬	rmnot
呵	rmnr
跺	rmnsd
跗	rmodi
踓	rmog
跈	rmohh
踗	rmoip
蹌	rmoir
踟	rmokr
踚	rmomb
跧	rmomg
踰	rmomn
跲	rmomr
踰	rmomv
趷	rmon
躌	rmotq
踇	rmowy
踘	rmpfd
趵	rmpi
趵	rmpm
蹞	rmpmc
跑	rmpru
跇	rmpt
蹀	rmptd
踳	rmqka
蹖	rmqkx
蹟	rmqmc
趺	rmqo
嗝	rmrb
躁	rmrrd
踀	rmryo
踙	rmsje
躡	rmsjj
踞	rmsjr
踂	rmsju
躍	rmsmg
啄	rmso
跜	rmsp
距	rmss
跼	rmssr
蹍	rmstv
呃	rmsu
跽	rmsup
踖	rmta
躪	rmtag
躨	rmtce
蹼	rmtco
躇	rmtja
躑	rmtkl
蹣	rmtlb
踑	rmtmc
踸	rmtmv
噘	rmto
躤	rmtqa
蹉	rmtqm
跰	rmtt
踫	rmttc
蹧	rmtwa
蹲	rmtwi
噆	rmua
蹦	rmubb
嗄	rmue
嘎	rmui
踹	rmumb
呀	rmvh
嗕	rmvi
躒	rmvid
躖	rmvim
蹡	rmvmi
躐	rmvvv
踝	rmwd
嘌	rmwf
喱	rmwg
嘾	rmwj
喕	rmwl
躅	rmwli
蹕	rmwtj
喓	rmwv
踔	rmyaj
蹄	rmybb
躘	rmybp
蹢	rmycb
跤	rmyck
嘕	rmyf
踧	rmyfe
蹴	rmyfu
跓	rmyg
躂	rmygq
蹥	rmyjj
跡	rmylc
踄	rmylh
趾	rmylm
跐	rmymp
躚	rmymu
踤	rmyoj
躆	rmypo
跕	rmyr
躟	rmyrv
踣	rmytr
踥	rmytv
躋	rmyx
唃	rnbg
嘝	rnbj
喚	rnbk
吇	rnd
吼	rndu
吜	rng
噊	rnhb
吸	rnhe
啗	rnhx
哆	rnin
唌	rnkm
啊	rnlr
吹	rno
嚵	rnri
嚕	rnwa
吶	rob
咻	rod
咐	rodi
唯	rog
嗿	roic
呤	roii
吟	roin
唸	roip
嗆	roir
唅	roir
吘	roj
吤	roll
噲	roma
唋	romd
啣	roml
喻	romn
噞	romo
哈	romr
啥	romr
喻	romv
吃	ron
喉	ronk
唑	roog
吪	rop
哖	roq
啽	rort
咋	ros
咿	rosk
嘸	rotf
噙	royb
叱	rp
咰	rpa
咇	rph
吻	rphh
唿	rphp
刡	rpln
呁	rpmm
敃	rpok
啕	rpou
喈	rppa
呴	rpr
咆	rpru
喋	rptd
吨	rpu
噸	rpuc
哅	rpuk
啪	rqha
喫	rqhk
哳	rqhl
囓	rqhu
嘒	rqjm
唪	rqkq
嘖	rqmc
嗉	rqmf
咑	rqmn
啦	rqyt
唈	rrau
斝	rrbyj
喣	rrf
鷺	rrhaf
咒	rrhn
咒	rrhu
哭	rrik
獸	rrik
器	rrikr
喌	rrill
囂	rrmcr
嚴	rrmmk
咢	rrmms
呺	rrms
郘	rrnl
品	rrr
噪	rrrd
喿	rrrd
嘽	rrrj
碞	rrrr
喦	rrru
嚚	rrslr
噀	rruc
嘂	rrvlr
呡	rrvp
單	rrwj
鼉	rrwmu
哫	rryo
唰	rsbn
囑	rsei
叨	rsh
鶚	rshaf
鴞	rshaf
嚂	rsit
咠	rsj
咡	rsj
囁	rsjj
叩	rsl
咂	rslb
別	rsln
叼	rsm
顎	rsmbc
唚	rsme
嚁	rsmg
喔	rsmg
嘐	rsmh
噚	rsmi
噿	rsmj
嚂	rsmt
鄂	rsnl
呎	rso
呢	rsp
嗎	rsqf
哪	rsql
嘔	rsrr
啒	rsuu
號	rsypn
號	rsypu
唶	rta
嗼	rtak
噶	rtav
哄	rtc
嘶	rtcl
噗	rtco
嗌	rtct
囈	rtgi
唴	rtgu
哎	rtk
喏	rtkr
嚥	rtlf
嘆	rtlo
咁	rtm
唭	rtmc
嘩	rtmj
啿	rtmv
囌	rtnd
嗏	rtod
嚄	rtoe
嗒	rtor
咩	rtq
嗟	rtqm
嚾	rtrg
嗍	rtub
喵	rtw
嘈	rtwa
噂	rtwi
囆	rtwi
噥	rtwv
嗛	rtxc
嚆	rtyb
巳	ru
喘	rumb
嗤	rumi
鄳	runl
嗺	ruog
饕	ruoiv
巽	rutc
咄	ruu
呶	rve
喲	rvfi
吆	rvi
嘰	rvii
呦	rvis
叫	rvl
吳	rvnk
喙	rvno
民	rvp
嗈	rvvu
喟	rwb
呬	rwc
哩	rwg
嘿	rwgf
嚜	rwgg
嘓	rwim
咽	rwk
嗯	rwkp
呷	rwl
喁	rwlb
嘪	rwlc
囉	rwlg
噣	rwli
噮	rwlv
喂	rwmv
鄙	rwnl
嗢	rwot
嗶	rwtj
呣	rwyi
黽	rxu
啅	ryaj
噷	ryao
啼	rybb
嚨	rybp
嗙	rybs
嘀	rycb
咬	ryck
囃	rydg
嚫	rydu
噈	ryfu
噠	rygq
嚬	ryhc
喭	ryhh
吭	ryhn
唷	ryib
嗹	ryjj
呅	ryk
喭	rykh
啃	rymb
噦	rymh
呲	rymp
唁	rymr
嚙	rymu
足	ryo
啐	ryoj
嘴	rypb
喍	rypd
噳	rypk
噓	rypm
唬	rypn
噱	rypo
嚧	rypt
唬	rypu
呫	ryr
嗃	ryrb
啍	ryrd
哼	ryrn
嚎	ryro
喨	ryru
嚷	ryrv
嗾	rysk
唹	rysy
喑	ryta
噫	rytp
唼	rytv
噰	ryvg
咳	ryvo
嚃	rywe
嚌	ryx
尸	s
鷵	sahaf
飁	sahni
翫	sammu
匽	sav
屭	sbcc
朢	sbhg
刷	sbln
匷	sbug
匹	sc
鴄	schaf
殿	schne
層	scwa
尿	se
腎	seb
臀	seb
賢	sebuc
贀	sebuc
鋻	sec
棸	sed
焣	sef
堅	seg
壂	seg
鷖	sehaf
聚	sehho
犀	sehq
蜸	selmi
醫	semcw
瑿	semgi
毉	semoo
硻	semr
豎	semrt
匯	seog
聚	seooo
掔	seq
翳	sesmm
娶	sev
嫛	sev
婜	sev
緊	sevif
繄	sevif
黳	sewgf
屬	sewi
馹	sfa
騴	sfajv
駻	sfamj
騠	sfamo
騉	sfapp
騔	sfapv
屑	sfb
騧	sfbbr
騆	sfbgr
駔	sfbm
駧	sfbmr
駉	sfbr
騱	sfbvk
駾	sfcru
驓	sfcwa
屎	sfd
尉	sfdi
駃	sfdk
駷	sfdl
騋	sfdoo
馭	sfe
騷	sfeii
驎	sffdq
驍	sfggu
騜	sfhag
騬	sfhdp
駱	sfher
駪	sfhgu
騮	sfhhw
驕	sfhkb
颿	sfhni
馲	sfhp
騙	sfhsb
騸	sfhsm
騩	sfhui
驄	sfhwp
騪	sfhxe
駺	sfiav
駿	sfice
馻	sfihu
驂	sfiih
駥	sfij
騃	sfiok
駘	sfir
駴	sfit
駹	sfiuh
驖	sfjig
驞	sfjmc
駝	sfjp
馱	sfk
駁	sfkk
騎	sfkmr
馽	sfl
駛	sflk
馴	sflll
駣	sflmo
騑	sflmy
驥	sflpc
駎	sflw
騁	sflws
驌	sflx
驦	sfmbu
駍	sfmfj
駓	sfmfm
騵	sfmhf
駤	sfmig
馯	sfmj
驪	sfmmp
驃	sfmwf
驔	sfmwj
騕	sfmwv
驈	sfnhb
騥	sfnhd
馺	sfnhe
騝	sfnkq
騤	sfnok
騛	sfnoo
駙	sfodi
騅	sfog
駗	sfohh
駖	sfoii
駇	sfok
駼	sfomd
駩	sfomg
驗	sfomo
騇	sfomr
馳	sfpd
駜	sfph
馰	sfpi
騊	sfpou
駒	sfpr
騶	sfpuu
騞	sfqjr
駽	sfrb
驒	sfrrj
騢	sfrse
驟	sfseo
驫	sfsff
駋	sfshr
駬	sfsj
騽	sfsma
駸	sfsme
驏	sfsnd
驅	sfsrr
駏	sfss
駶	sfssr
馵	sft
騲	sftaj
騚	sftbn
驧	sftjd
驠	sftlf
騹	sftlm
騏	sftmc
驊	sftmj
驩	sftrg
駢	sftt
騣	sfuce
驨	sfuob
騄	sfvne
駟	sfwc
騍	sfwd
駰	sfwk
驛	sfwlj
驆	sfwtj
騾	sfwvf
駮	sfyck
驐	sfydk
駐	sfyg
褧	sfyhv
驉	sfypm
驢	sfypt
驤	sfyrv
騂	sfyt
騿	sfytj
駭	sfyvo
驙	sfywm
鸐	sghaf
戳	sgi
聽	sgjwp
劻	sgks
剭	sgln
刀	sh
鳲	shaf
兔	shahi
鬄	shaph
鬘	shawe
鬅	shbb
匴	shbt
負	shbuc
鬙	shcwa
鬎	shdbn
鬆	shdci
髲	shdhe
瘌	shdln
髾	shfb
鬈	shfqu
髯	shgb
髻	shgr
鷚	shhaf
鳭	shhaf
鬁	shhdn
髼	shhej
鬚	shhhc
髺	shhjr
髡	shhn
髦	shhqu
刃	shi
戮	shi
鬖	shiih
髮	shikk
鬒	shjbc
鬢	shjmc
鬃	shjmf
鬐	shjpa
鬍	shjrb
髮	shke
鬌	shkmb
髧	shlbu
彿	shlln
顟	shmbc
髬	shmfm
匠	shml
髡	shmu
髳	shnih
鄝	shnl
屩	shob
髹	shod
屧	shod
履	shoe
屐	shoe
雡	shog
鬠	shoma
屣	shoo
髽	shoog
屜	shot
屨	shov
髱	shpru
鬊	shqka
尾	shqu
召	shr
匾	shsb
髫	shshr
髶	shsj
鬕	shtak
鬋	shtbn
鬗	shtlb
髷	shtw
鬞	shtwv
鬑	shtxc
鬣	shvvv
鬟	shwlv
髣	shyhs
髭	shymp
鬤	shyrv
監	sibt
熨	sif
髟	sihhh
镺	sihk
斸	sihml
犚	sihq
镻	sihqo
镽	sikcf
肆	silq
鄩	sinl
忍	sip
慰	sip
镼	sisuu
褽	siyhv
耳	sj
臂	sjb
屄	sjc
聬	sjcim
檗	sjd
取	sje
郰	sjenl
耿	sjf
糪	sjfd
壁	sjg
聃	sjgb
聐	sjgr
鷿	sjhaf
聊	sjhhl
聒	sjhjr
毦	sjhqu
聰	sjhwp
聝	sjirm
聜	sjjcm
匭	sjjn
聹	sjjpn
屠	sjka
屪	sjkf
耾	sjki
幦	sjlb
耽	sjlbu
聵	sjlmc
刵	sjln
聘	sjlws
顳	sjmbc
聏	sjmbl
璧	sjmgi
耵	sjmn
甓	sjmvn
聇	sjmym
聸	sjncr
耶	sjnl
聧	sjnok
聆	sjoii
耹	sjoin
恥	sjp
憵	sjp
擘	sjq
居	sjr
鼊	sjrxu
躄	sjryo
劈	sjsh
聑	sjsj
聶	sjsjj
耴	sju
嬖	sjv
繴	sjvif
聈	sjvis
聯	sjvit
襞	sjyhv
職	sjyia
恥	sjylm
譬	sjymr
聤	sjyrn
尹	sk
尻	skn
君	skr
卩	sl
匝	slb
屢	sllv
頤	slmbc
匱	slmc
匪	slmy
屝	slmy
臥	slo
臨	slorr
賾	slqmc
臣	slsl
臦	slsll
臥	sly
刁	sm
翨	smamo
翬	smbjj
帚	smblb
監	smbt
翂	smcsh
翍	smdhe
匡	smg
習	smha
翵	smhaf
翐	smhqo
毣	smhqu
屋	smig
翇	smikk
翜	smkoo
翀	sml
羾	smm
頨	smmbc
尋	smmri
屍	smnp
翟	smog
翏	smohh
翭	smonk
翑	smpr
司	smr
羽	smsim
羿	smt
翪	smuce
長	smv
翼	smwtc
翴	smyjj
翠	smyoj
翯	smyrb
翞	smyrf
翌	smyt
翋	smyt
翣	smytv
孱	sndd
屙	snlr
尺	so
匼	somr
鄹	sonl
咫	sorc
尼	sp
匜	spd
鵋	sphaf
匢	sphh
屁	spp
那	sqnl
馬	sqsf
叵	sr
盬	srbt
覗	srbuu
焄	srf
鷗	srhaf
鶋	srhaf
鵘	srhaf
聖	srhg
毆	srhne
劭	srks
屌	srlb
頵	srmbc
甌	srmvn
郡	srnl
邵	srnl
歐	srno
慝	srp
匰	srrj
區	srrr
卲	srsl
群	srtq
群	srtq
敺	srye
辟	srytj
巨	ss
燛	ssf
臩	sskll
螶	sslii
局	ssr
凹	ssu
兕	ssuu
匿	stkr
羼	stqq
屏	stt
展	stv
己	su
已	su
熙	suf
屆	sug
鶌	suhaf
屘	sund
邔	sunl
改	suok
忌	sup
异	sut
屈	suu
媐	suv
妀	suv
鶠	svhaf
郾	svnl
屇	sw
鹽	swbt
覽	swbuu
鑒	swc
匣	swl
匟	syhn
屏	syjj
屖	sytj
廿	t
昔	ta
菖	taa
萌	tab
萺	tabu
皵	tadhe
蒔	tagi
鵲	tahaf
斮	tahml
蔇	taiu
草	taj
莫	tak
暮	taka
幕	takb
驀	takf
墓	takg
慕	takp
摹	takq
募	taks
剒	taln
菛	tan
蕑	tanb
藺	tang
蕄	tanp
蘭	tanw
葃	taos
菎	tapp
葛	tapv
蕞	tase
芭	tau
茛	tav
蔓	tawe
蓂	tbac
萉	tbau
蓇	tbbb
薆	tbbe
蕣	tbbq
萵	tbbr
薍	tbbu
覯	tbbuu
典	tbc
萴	tbcn
黺	tbcsh
蘡	tbcv
菜	tbd
槊	tbd
藤	tbfe
塑	tbg
蒍	tbhf
薶	tbhg
藐	tbhu
黼	tbijb
黻	tbikk
葷	tbjj
勱	tbks
繭	tbli
前	tbln
蒯	tbln
苴	tbm
顜	tbmbc
顢	tbmbc
萲	tbme
蒙	tbmo
茼	tbmr
莇	tbms
蒏	tbmw
莩	tbnd
煎	tbnf
剪	tbnh
蒬	tbni
翦	tbnm
蔡	tbof
散	tbok
葄	tbos
愬	tbp
葋	tbpr
菔	tbse
菵	tbtv
苜	tbu
蔝	tbud
藈	tbuk
薡	tbul
萛	tbut
莧	tbuu
荽	tbv
斠	tbyj
共	tc
菳	tc
普	tca
期	tcb
益	tcbt
腆	tcbuu
黹	tcfb
基	tcg
鶼	tchaf
鷬	tchaf
夔	tche
斯	tchml
蓊	tcim
輂	tcjwj
蛬	tclmi
碁	tcmr
欺	tcno
歉	tcno
恭	tcp
惎	tcp
拲	tcq
巷	tcru
莌	tcru
棻	tcsd
芬	tcsh
葐	tcst
巷	tcsu
業	tctd
叢	tcte
綦	tcvif
酋	tcwm
黈	tcyg
斢	tcyj
諅	tcymr
茦	tdb
蕀	tdbb
蓛	tdbk
莿	tdbn
葙	tdbu
菘	tdci
菻	tdd
鷋	tdhaf
菥	tdhl
茉	tdj
芵	tdk
藾	tdlc
蔌	tdlo
苯	tdm
葦	tdmq
鄴	tdnl
萊	tdoo
莕	tdr
藲	tdsr
菄	tdw
萰	tdwf
蕩	teah
薀	teat
菹	tebm
鑿	tec
莯	ted
菠	tede
莎	tefh
蔆	tege
落	tehr
萿	tehr
蒎	tehv
藩	tehw
蒲	teib
薄	teii
蒗	teiv
莐	telu
茳	tem
薸	temf
萍	temj
藫	temj
菏	temr
莈	tene
蒤	teod
虃	teom
蕍	teon
蒞	teot
藻	terd
蕖	tesd
菬	tesr
菃	tess
范	tesu
蓱	tett
蕅	tewb
薀	tewt
薃	teyb
蔋	teye
蒞	teyt
蓅	teyu
茫	teyv
苂	tf
蔊	tfaj
莦	tfb
蔽	tfbk
萷	tfbn
菼	tff
藀	tfff
蘱	tfkc
虌	tfku
薠	tfmc
茪	tfmu
酀	tfnl
菤	tfqu
芏	tg
苒	tgb
蓋	tgbt
觀	tgbuu
菱	tgce
對	tgdi
羨	tgeno
羔	tgf
羹	tgftk
茥	tgg
葑	tggi
蓺	tggi
蕘	tggu
鸛	tghaf
羲	tghds
飌	tghni
義	tghqi
羌	tghu
爇	tgif
藝	tgii
羨	tgimo
羕	tgine
蓋	tgit
蕔	tgje
蓻	tgji
美	tgk
勸	tgks
羛	tglln
顴	tgmbc
薵	tgni
酄	tgnl
歡	tgno
羑	tgno
莰	tgno
臡	tgobo
薔	tgow
恙	tgp
戁	tgp
荺	tgpm
薹	tgrg
蔜	tgsk
薣	tgte
善	tgtr
姜	tgv
藚	tgwc
蘾	tgyv
蔦	thaf
蘤	thaf
葟	thag
菂	thai
葩	thau
虋	thbh
薁	thbk
首	thbu
藰	thcn
萫	thda
蕱	thdb
薐	thde
萩	thdf
蕛	thdh
菞	thdh
蒩	thdm
莉	thdn
莠	thds
萎	thdv
藒	thdv
蕃	thdw
茖	ther
苳	they
薰	thgf
鶜	thhaf
蕦	thhc
藜	thhd
藜	thhe
茆	thhl
芊	thj
茱	thjd
葮	thje
董	thjg
菙	thjm
芺	thk
蕎	thkb
菾	thkp
萭	thlb
蘌	thlf
蘬	thmb
芹	thml
茩	thmr
藜	thnd
芟	thne
芃	thni
蕧	thoe
薇	thok
藢	thok
蓹	thol
荇	thon
蘅	thon
蓯	thoo
蓗	thoo
蓏	thoo
葎	thoq
莪	thqi
苵	thqo
芼	thqu
薛	thrj
萹	thsb
菺	thsb
蒑	thse
薂	thsk
蔰	thsu
蒐	thui
蒠	thup
蘶	thvi
萆	thwj
蔥	thwp
蓖	thwp
藇	thxc
蕮	thxf
萸	thxo
蒰	thye
莨	tiav
蒪	tibi
荾	tice
藦	ticq
蘑	ticr
蘼	ticy
麻	tidd
藦	tidq
蘑	tidr
蘼	tidy
茂	tih
鷷	tihaf
蕆	tihc
菧	tihm
葴	tihr
蒧	tihr
荿	tihs
葳	tihv
蔘	tiih
茙	tij
莆	tijb
麻	tijc
莍	tije
蒍	tikf
茇	tikk
莽	tikt
菮	tilo
蓎	tilr
茨	timo
藏	tims
芝	tino
薋	tioc
懟	tip
芅	tip
蘪	tipd
藨	tipf
苔	tir
蓆	titb
薕	titc
蔗	titf
薦	tixf
蔍	tixp
卅	tj
靼	tjam
鞮	tjamo
鞨	tjapv
靶	tjau
鞎	tjav
韅	tjavf
芾	tjb
荸	tjbd
萳	tjbj
靻	tjbm
萓	tjbm
葖	tjck
藭	tjcn
蓉	tjcr
鞁	tjdhe
靺	tjdj
葧	tjds
芰	tje
鞜	tjea
蘻	tjef
鞘	tjfb
鞝	tjfbr
靽	tjfq
鞋	tjgg
鞊	tjgr
韇	tjgwc
鷨	tjhaf
鞂	tjhd
鞦	tjhdf
靳	tjhml
鞞	tjhwj
蓴	tjii
蕙	tjip
鞚	tjjcm
蓒	tjjj
蔪	tjjl
鞍	tjjv
著	tjka
荖	tjkp
勒	tjks
鞅	tjlbk
鞻	tjllv
萐	tjlo
萋	tjlv
蔩	tjmc
蔻	tjme
靬	tjmj
萱	tjmm
靪	tjmn
苧	tjmn
萣	tjmo
菪	tjmr
靰	tjmu
莞	tjmu
韁	tjmwm
鞔	tjnau
孽	tjnd
鞣	tjnhd
靸	tjnhe
鞃	tjni
鞬	tjnkq
靷	tjnl
鄿	tjnl
菀	tjnu
蓿	tjoa
靲	tjoin
鞭	tjomk
鞈	tjomr
靴	tjop
鞥	tjort
蓍	tjpa
鞠	tjpfd
靮	tjpi
靮	tjpm
薴	tjpn
鞄	tjpru
靾	tjpt
鞢	tjptd
蔤	tjpu
鞫	tjpyr
鞡	tjqyt
苦	tjr
葫	tjrb
鞙	tjrb
菅	tjrr
躠	tjryo
韌	tjshi
鞀	tjshr
蕡	tjtc
韉	tjtif
韄	tjtoe
鞳	tjtor
藆	tjtq
荌	tjv
鞿	tjvii
靿	tjvis
莗	tjwj
鞹	tjydl
韃	tjygq
韆	tjymu
艾	tk
蔱	tkce
檠	tkd
苃	tke
鶧	tkhaf
鴱	tkhaf
荻	tkhf
莥	tkhg
藱	tkhi
蕕	tkhw
莃	tkkb
荐	tkld
茬	tklg
蟼	tklmi
菴	tklu
荂	tkms
荑	tkn
艽	tkn
芄	tkni
鄭	tknl
鄚	tknl
蒺	tkok
莢	tkoo
憼	tkp
蔕	tkpb
擎	tkq
若	tkr
惹	tkrp
驚	tksqf
茄	tksr
荔	tkss
警	tkymr
英	tlbk
革	tlj
蟴	tllmi
茀	tlln
蔞	tllv
蕢	tlmc
茧	tlmi
藎	tlmt
菲	tlmy
燕	tlpf
鷰	tlpf
堇	tlqm
韭	tlsm
藪	tlvk
苖	tlw
黃	tlwc
蕭	tlx
甘	tm
普	tma
荁	tmam
薷	tmbb
藿	tmbg
蕓	tmbi
蕶	tmbi
荋	tmbl
蘦	tmbr
覲	tmbuu
蕾	tmbw
茜	tmcw
莤	tmcw
某	tmd
芋	tmd
芣	tmf
薾	tmfb
蒜	tmff
苹	tmfj
苤	tmfm
蘸	tmgf
菿	tmgn
薽	tmgn
蘁	tmgr
蒝	tmhf
蕥	tmhg
藶	tmhm
斳	tmhml
荎	tmig
荊	tmjn
菾	tmkp
勤	tmks
菫	tmlm
其	tmmc
芸	tmmi
茨	tmmo
葝	tmms
芫	tmmu
甚	tmmv
艼	tmn
薚	tmnh
茿	tmnj
邯	tmnl
鄞	tmnl
薤	tmnm
茢	tmnn
苛	tmnr
蒆	tmnv
薞	tmnv
藸	tmoa
苪	tmob
蕤	tmom
莁	tmoo
葬	tmpt
蒚	tmrb
藞	tmrr
荳	tmrt
葍	tmrw
華	tmtj
荊	tmtn
蕨	tmto
芽	tmvh
蓐	tmvi
莖	tmvm
蔈	tmwf
蕈	tmwj
薑	tmwm
葽	tmwv
芐	tmy
蔫	tmyf
齹	tmymu
芎	tn
菟	tnai
萯	tnbc
藑	tnbe
薢	tnbq
薝	tncr
芓	tnd
蓀	tndf
菰	tndo
芤	tndu
蒸	tnef
蘇	tnfd
薊	tnfn
蘚	tnfq
葇	tnhd
芨	tnhe
艿	tnhs
蓩	tnhs
萏	tnhx
苰	tni
茅	tnih
芧	tnin
茤	tnin
荈	tniq
茗	tnir
苑	tniu
蕵	tniv
莛	tnkg
莚	tnkm
藬	tnlc
蒢	tnld
蔭	tnli
薩	tnlm
蘟	tnlp
蔯	tnlw
蒻	tnmm
蔬	tnmu
蕷	tnnc
鄸	tnnl
芡	tno
葵	tnok
葞	tnsj
虇	tntg
葾	tnup
葂	tnus
艱	toav
芮	tob
蒮	tobg
茶	tod
茠	tod
苻	todi
苶	tof
萑	tog
茌	tog
蕉	togf
舊	togx
鸏	tohaf
荏	tohg
氋	tohqu
茷	toi
養	toiav
葰	toie
苓	toii
茯	toik
芩	toin
蒼	toir
蘩	tokf
薙	tokg
蓨	tolb
蓧	told
芥	toll
薈	toma
菕	tomb
蘥	tomb
荼	tomd
荃	tomg
芢	tomm
芞	tomn
薟	tomo
荷	tomr
荅	tomr
葔	tonk
歎	tono
鯗	tonwf
蓌	tooe
難	toog
莝	toog
蘞	took
葅	toom
莋	toos
花	top
蒨	toqb
葆	tord
苲	tos
葠	tose
蕪	totf
蒛	touk
莓	towy
蓓	toyr
蒞	toyt
芯	tp
荀	tpa
菊	tpfd
苾	tph
芴	tphh
芍	tpi
芶	tpi
葡	tpib
薿	tpko
蔥	tpkp
芍	tpm
蔔	tpmw
萄	tpou
芘	tpp
蕊	tppp
苟	tpr
苞	tpru
葉	tptd
芚	tpu
蘹	tpyv
羊	tq
羋	tq
羯	tqapv
著	tqbu
羒	tqcsh
藉	tqda
藕	tqdb
莏	tqfh
羳	tqhdw
羖	tqhne
羝	tqhpm
葀	tqhr
蒱	tqib
羧	tqice
羬	tqihr
羢	tqij
菝	tqik
羻	tqixe
蔧	tqjm
羜	tqjmn
羦	tqjmu
羵	tqjtc
萶	tqka
蓁	tqkd
羠	tqkn
菶	tqkq
菗	tqlw
差	tqm
菁	tqmb
羺	tqmbb
羱	tqmhf
羥	tqmvm
羞	tqng
芙	tqo
蓷	tqog
羚	tqoii
羭	tqomn
羷	tqomo
恙	tqp
菢	tqpu
荴	tqqo
翔	tqsmm
羰	tqumf
蘀	tqwj
菈	tqyt
羶	tqywm
莒	trhr
菋	trjd
蕺	trji
蘄	trjl
蕗	trmr
鄯	trnl
鄀	trnl
蓶	trog
敬	trok
荶	tron
雚	trrg
蕇	trrj
虈	trrr
萼	trrs
葭	trse
葺	trsj
苠	trvp
蘙	tsem
藂	tseo
蔚	tsfi
芀	tsh
苕	tshr
萏	tshx
蕻	tsic
荵	tsip
藯	tsip
蕼	tsiq
藍	tsit
茸	tsj
蘵	tsja
蘗	tsjd
菆	tsje
芛	tsk
莙	tskr
菣	tsle
茞	tsll
藋	tsmg
蓼	tsmh
蕁	tsmi
藍	tsmt
萇	tsmv
懃	tsp
苨	tsp
蔒	tsrf
薜	tsrj
蓲	tsrr
苣	tss
芑	tsu
井	tt
并	tt
卌	tt
葥	ttbn
並	ttc
藄	ttcf
蘣	ttcg
蘳	ttcg
冓	ttgb
蓔	ttgf
薱	ttgi
鷁	tthaf
鵧	tthaf
丼	tti
蘜	ttjd
蓳	ttlm
荊	ttln
並	ttm
頩	ttmbc
萁	ttmc
葚	ttmv
瓶	ttmvn
豔	ttnau
艵	ttnau
郱	ttnl
蒫	ttqm
善	ttr
刱	ttshi
荓	ttt
蒴	ttub
蘛	ttvb
蠲	ttwli
蒹	ttxc
朔	tub
馘	tuirm
蘴	tujt
菡	tune
茁	tuu
蕬	tvff
蒶	tvfh
葯	tvfi
葒	tvfm
蘊	tvft
蕝	tvfu
蔠	tvfy
薌	tvhl
戡	tvi
藥	tvid
孳	tvid
鶿	tvif
茲	tvii
苡	tvio
慈	tvip
苭	tvis
菇	tvjr
勘	tvks
荍	tvlk
莊	tvmg
蔣	tvmi
薅	tvmi
蘠	tvmw
菉	tvne
歁	tvno
茹	tvr
蕠	tvrf
蒘	tvrq
葌	tvvv
菑	tvvw
斟	tvyj
苗	tw
曲	tw
曹	twa
蠆	twbi
躉	twbo
莔	twcb
果	twd
尊	twdi
蔨	twfu
菌	twhd
猷	twik
蔮	twim
奠	twk
茵	twk
莮	twks
薯	twla
萬	twlb
蘉	twle
蘿	twlg
蔑	twli
薎	twli
蠤	twlii
夢	twln
甍	twln
藅	twln
蘮	twln
薨	twlp
藣	twlp
瞢	twlu
農	twmmv
豊	twmrt
葨	twmv
苬	two
葸	twp
茴	twr
蓽	twtj
蔂	twvf
虆	twwf
蘲	twwg
藟	twww
苺	twyi
兼	txc
蒂	tybb
薖	tybb
蘺	tybg
藃	tybo
蘢	tybp
蒡	tybs
蔏	tycb
茭	tyck
萒	tycu
蔉	tycv
薪	tydl
藗	tydo
藽	tydu
菽	tyfe
薘	tygq
薳	tygv
蘋	tyhc
蓬	tyhj
苀	tyhn
芳	tyhs
茺	tyiu
蓮	tyjj
芠	tyk
芷	tylm
薉	tymh
蓫	tymo
茈	tymp
蓪	tynb
藙	tyoe
萃	tyoj
蔖	typm
藘	typp
蘆	typt
苫	tyr
藷	tyra
蒿	tyrb
蕸	tyre
蔎	tyre
蔀	tyrl
葶	tyrn
薧	tyrp
蘘	tyrv
藹	tyrv
葹	tysd
蔟	tysk
虀	tysm
蔙	tyso
菸	tysy
苙	tyt
萻	tyta
蕫	tytg
莘	tytj
薏	tytp
菩	tytr
蒟	tytr
菨	tytv
芒	tyv
蕹	tyvg
荄	tyvo
莣	tyvp
荒	tyvu
蓄	tyvw
蓾	tywi
蓑	tywv
薺	tyx
藡	tyyb
蘧	tyyo
山	u
嵋	uahu
崵	uamh
崼	uamo
崑	uapp
嵑	uapv
峎	uav
崩	ubb
崱	ubcn
剬	ubln
剻	ubln
岨	ubm
顓	ubmbc
峒	ubmr
酅	ubnl
歂	ubno
崢	ubsd
崗	ubtu
峴	ubuu
崟	uc
嶔	ucno
峪	ucor
嶒	ucwa
崧	udci
岥	udhe
崍	udoo
糶	udsmg
崠	udw
嵀	udyg
顄	uembc
峭	ufb
嶙	ufdq
嶸	uffd
巆	uffr
嶗	uffs
巀	ufgi
崚	ugce
峙	ugdi
崶	uggi
嶢	uggu
崁	ugno
匕	uh
岶	uha
崲	uhag
嵙	uhdj
嵊	uhdp
崣	uhdv
嶓	uhdw
峰	uhej
峰	uhej
峉	uher
峈	uher
嵧	uhhw
岆	uhk
嶠	uhkb
巋	uhmb
岓	uhml
嵐	uhni
嵷	uhoo
嵂	uhoq
崏	uhpa
峨	uhqi
嵨	uhrf
嶭	uhrj
巑	uhuc
嵲	uhud
嵬	uhui
巍	uhvi
崥	uhwj
嶼	uhxc
崀	uiav
峻	uice
嵅	uihr
峸	uihs
崴	uihv
嵾	uiih
峬	uijb
嵣	uilr
鬯	uip
岤	ujc
巔	ujcc
崆	ujcm
嵱	ujcr
櫱	ujd
岐	uje
糱	ujfd
嶄	ujjl
峔	ujkp
蠥	ujlmi
崨	ujlo
崇	ujmf
豐	ujmrt
孽	ujnd
岮	ujp
岵	ujr
峖	ujv
凶	uk
峟	ukb
嶚	ukcf
峚	ukg
嶽	ukhk
兇	ukhu
輋	ukjj
崤	ukkb
崦	uklu
崎	ukmr
峓	ukn
峽	ukoo
嵽	ukpb
屴	uks
屮	ul
岟	ulbk
岪	ulln
嶁	ullv
岫	ulw
峘	umam
崸	umbc
耑	umbl
峏	umbl
嶀	umbs
炭	umf
岯	umfm
崖	umgg
峌	umig
蚩	umli
岸	ummj
峿	ummr
岏	ummu
嵿	umnc
峛	umnn
岢	umnr
豳	umoo
岩	umr
豈	umrt
岍	umt
崋	umtj
嶡	umto
屼	umu
嶜	umua
岈	umvh
嶰	unbq
函	une
岌	unhe
岋	unhe
嵹	unii
峗	unmu
峞	unmu
嶝	unot
嵥	unqd
巉	unri
崔	uog
巂	uogb
雟	uogb
嶕	uogf
嶲	uogs
嶺	uoic
岭	uoii
岑	uoin
岒	uoin
嵢	uoir
岕	uoll
崙	uomb
崳	uomn
嶮	uomo
峇	uomr
峆	uomr
屹	uon
岝	uos
峋	upa
岉	uphh
嶷	upko
岣	upr
崝	uqmb
嶊	uqog
嶯	urji
嶉	urog
巖	urrk
崿	urrs
屺	uru
岷	urvp
屻	ushi
岧	ushr
崌	usjr
峮	uskr
嶍	usma
嵺	usmh
嶇	usrr
岠	uss
屺	usu
崛	usuu
嶱	utav
覬	utbuu
嶪	utcd
崷	utcw
嶬	utgi
豔	utgit
凱	uthn
颽	uthni
巕	uthv
獃	utik
剴	utln
顗	utmbc
嵌	utmo
嵁	utmv
艷	utnau
酆	utnl
敳	utok
嵯	utqm
巏	utrg
嵫	utvi
嶆	utwa
嶟	utwi
嶩	utwv
出	uu
艸	uu
屾	uu
嵕	uuce
祟	uummf
芔	uuu
茻	uuuu
幽	uvii
岰	uvis
嶈	uvmi
崰	uvvw
崮	uwjr
岬	uwl
嵎	uwlb
嶧	uwlj
嶵	uwly
崽	uwp
崹	uybb
巘	uybk
巃	uybp
嵃	uyhh
嵼	uyhm
嵃	uykh
嵼	uykm
崒	uyoj
嵩	uyrb
崞	uyrd
嵉	uyrn
崺	uysd
岦	uyt
巇	uyti
嶂	uytj
峷	uytj
峐	uyvo
女	v
娼	vaa
媼	vabt
媢	vabu
媚	vahu
妲	vam
婸	vamh
媞	vamo
嫺	vanb
嫻	vand
嫚	vawe
嫇	vbac
嬡	vbbe
姍	vbbm
媧	vbbr
婇	vbd
婤	vbgr
婬	vbhg
嫍	vbhx
姐	vbm
媛	vbme
姛	vbmr
媱	vbou
姍	vbt
娊	vbuu
娞	vbv
妐	vci
娣	vcnh
妢	vcsh
妺	vdj
勦	vdks
娕	vdl
嬾	vdlc
嫩	vdlk
剿	vdln
鄛	vdnl
奴	ve
盝	vebt
努	veks
帑	velb
剝	veln
砮	vemr
弩	ven
孥	vend
怒	vep
拏	veq
駑	vesqf
曫	vfa
縕	vfabt
緹	vfamo
緆	vfaph
緄	vfapp
繓	vfase
縵	vfawe
繃	vfbb
嫦	vfbb
縎	vfbbb
綬	vfbbe
緺	vfbbr
纓	vfbcv
綵	vfbd
綢	vfbgr
縚	vfbhx
緷	vfbjj
組	vfbm
緩	vfbme
絧	vfbmr
綒	vfbnd
縩	vfbof
綢	vfbqr
絅	vfbr
絼	vfbsh
綱	vfbtu
網	vfbtv
矕	vfbu
緲	vfbuh
繉	vfbuo
綏	vfbv
鑾	vfc
綈	vfcnh
綌	vfcor
紛	vfcsh
繒	vfcwa
欒	vfd
緗	vfdbu
綝	vfdd
紂	vfdi
綀	vfdl
絊	vfdm
緯	vfdmq
練	vfdwf
縔	vfeed
綴	vfeee
婒	vff
綃	vffb
繗	vffdq
緂	vfff
紗	vffh
絖	vffmu
絆	vffq
綣	vffqu
綾	vfgce
絓	vfgg
繞	vfggu
紶	vfgi
結	vfgr
纈	vfgrc
續	vfgwc
妙	vfh
綿	vfhab
線	vfhae
鸞	vfhaf
鷥	vfhaf
繌	vfhce
繡	vfhds
緌	vfhdv
繙	vfhdw
絳	vfheq
絡	vfher
終	vfhey
紝	vfhg
纁	vfhgf
絑	vfhjd
緞	vfhje
緟	vfhjg
綞	vfhjm
繑	vfhkb
絎	vfhon
縱	vfhoo
縰	vfhoo
綹	vfhor
綁	vfhql
紩	vfhqo
編	vfhsb
繳	vfhsk
綟	vfhsk
纘	vfhuc
紙	vfhvp
綼	vfhwj
總	vfhwp
綹	vfhyr
縛	vfibi
緘	vfihr
線	vfii
縿	vfiih
絨	vfij
絿	vfije
紎	vfik
紁	vfik
紱	vfikk
紌	vfiku
絒	vfill
絘	vfimo
紿	vfir
緎	vfirm
纊	vfitc
纏	vfiwg
縝	vfjbc
綍	vfjbd
縳	vfjii
繐	vfjip
緒	vfjka
緁	vfjlo
緀	vfjlv
繽	vfjmc
縯	vfjmc
綜	vfjmf
紵	vfjmn
綻	vfjmo
綄	vfjmu
綩	vfjnu
縮	vfjoa
紽	vfjp
縖	vfjqr
綰	vfjrr
縡	vfjyj
奱	vfk
繚	vfkcf
紘	vfki
絺	vfkkb
綺	vfkmr
紈	vfkni
紻	vflbk
紞	vflbu
繣	vflgm
紃	vflll
紼	vflln
縷	vfllv
繢	vflmc
蠻	vflmi
絩	vflmo
緋	vflmy
紬	vflw
紳	vflwl
絏	vflwp
繡	vflx
紅	vfm
絔	vfma
繻	vfmbb
纋	vfmbe
緛	vfmbk
紆	vfmd
紑	vfmf
緻	vfmge
緻	vfmgk
縓	vfmhf
縉	vfmia
絰	vfmig
緉	vfmlb
綆	vfmlk
紜	vfmmi
纚	vfmmp
糽	vfmn
縟	vfmvi
經	vfmvm
縹	vfmwf
緬	vfmwl
韁	vfmwm
彎	vfn
絕	vfnau
絻	vfnau
繲	vfnbq
孿	vfnd
紐	vfng
繘	vfnhb
級	vfnhe
繈	vfnii
紓	vfnin
繺	vfnkf
綎	vfnkg
綖	vfnkm
紖	vfnl
縃	vfnob
纔	vfnri
緮	vfoae
納	vfob
臠	vfobo
紨	vfodi
維	vfog
紾	vfohh
纖	vfoim
紟	vfoin
變	vfok
紒	vfoll
繪	vfoma
綸	vfomb
絟	vfomg
緶	vfomk
緰	vfomn
給	vfomr
紇	vfon
緱	vfonk
絁	vfopd
纀	vfoto
戀	vfp
您	vfp
絢	vfpa
約	vfpi
約	vfpm
緪	vfpmm
綯	vfpou
紕	vfpp
絇	vfpr
紲	vfpt
純	vfpu
縐	vfpuu
攣	vfq
姅	vfq
綁	vfqjl
縥	vfqkd
綪	vfqmb
績	vfqmc
縤	vfqmf
婘	vfqu
轡	vfr
絹	vfrb
縜	vfrbc
絽	vfrhr
緡	vfrpa
繰	vfrrd
繟	vfrrj
緝	vfrsj
繩	vfrxu
紉	vfshi
紹	vfshr
絕	vfshu
緅	vfsje
綅	vfsme
繆	vfsmh
紀	vfsu
纜	vfswu
縸	vftak
繖	vftbk
縊	vftct
緧	vftcw
繕	vftgr
緙	vftlj
紺	vftm
縒	vftqm
絣	vftt
繕	vfttr
繜	vftwi
繷	vftwv
縑	vftxc
巒	vfu
繃	vfubb
纗	vfuob
繀	vfuog
絀	vfuu
孌	vfv
絲	vfvif
糾	vfvl
綠	vfvne
緣	vfvno
繅	vfvvd
繼	vfvvi
緇	vfvvw
細	vfw
綑	vfwd
纆	vfwgg
絪	vfwk
纙	vfwlg
繹	vfwlj
繯	vfwlv
縕	vfwot
緦	vfwp
縪	vfwtj
縲	vfwvf
綽	vfyaj
締	vfybb
縍	vfybs
絞	vfyck
紸	vfyg
繨	vfygq
縫	vfyhj
縋	vfyhr
紡	vfyhs
織	vfyia
繂	vfyij
統	vfyiu
紏	vfyj
縺	vfyjj
紋	vfyk
繾	vfylr
綷	vfyoj
纑	vfypt
縞	vfyrb
綧	vfyrd
綡	vfyrf
纕	vfyrv
縼	vfyso
繸	vfyto
繶	vfytp
縌	vfytu
縭	vfyub
絃	vfyvi
絯	vfyvo
縴	vfyvq
繵	vfywm
縗	vfywv
姌	vgb
婈	vgce
焋	vgf
娃	vgg
嬈	vggu
奘	vgk
嬦	vgni
嬙	vgow
姞	vgr
嬯	vgrg
嬉	vgrr
媴	vgrv
婞	vgtj
裝	vgyhv
婂	vhab
媓	vhag
嬝	vhav
姠	vhbr
嬼	vhcn
姀	vhd
娳	vhdn
婑	vhdv
嬏	vhdw
妊	vhg
姺	vhgu
媹	vhhw
鄉	vhiil
奷	vhj
姝	vhjd
娷	vhjm
姡	vhjr
妖	vhk
嬌	vhkb
婖	vhkp
妡	vhml
姤	vhmr
姵	vhnb
奼	vhp
婚	vhpa
娥	vhqi
姓	vhqm
妒	vhs
媥	vhsb
鄉	vhsjl
嬓	vhsk
媿	vhui
媳	vhup
婢	vhwj
媲	vhwp
嫂	vhxe
婗	vhxu
幺	vi
厶	vi
娘	viav
嬤	vici
樂	vid
槳	vid
嬤	vidi
漿	vie
糸	vif
墏	vig
幾	vihi
斷	vihml
獎	viik
娀	vij
獎	vik
媯	vikf
幼	viks
鴢	viksf
嫞	vilb
嫝	vile
螿	vilmi
劙	viln
醬	vimcw
以	vio
娭	viok
始	vir
幻	vis
嬚	vitc
嫬	vitf
娏	viuh
畿	viw
婻	vjbj
嫆	vjcr
妹	vjd
妓	vje
奼	vjhp
嬸	vjhw
嫥	vjii
媎	vjka
姥	vjkp
婕	vjlo
嬪	vjmc
婃	vjmf
媗	vjmm
嫁	vjmo
婝	vjmo
婉	vjnu
嬣	vjpn
姑	vjr
媩	vjrb
嫴	vjrj
婠	vjrr
姲	vjv
姷	vkb
盭	vkbt
嫽	vkcf
婍	vkmr
姱	vkms
姨	vkn
嫉	vkok
凵	vl
姎	vlbk
嫿	vlgm
嚮	vlhbr
丱	vlllm
蠁	vllmi
爿	vlm
嬇	vlmc
姚	vlmo
嬧	vlmt
饗	vloiv
收	vlok
妯	vlw
妽	vlwl
娉	vlws
姊	vlxh
響	vlyta
妅	vm
姮	vmam
嬬	vmbb
將	vmbdi
嫮	vmbs
孀	vmbu
彙	vmbwd
床	vmd
嬭	vmfb
彝	vmfft
壯	vmg
娾	vmgg
牆	vmgow
嫄	vmhf
斨	vmhml
戕	vmi
姪	vmig
狀	vmik
奸	vmj
妍	vmjj
蠿	vmlii
婭	vmlm
妘	vmmi
牁	vmmnr
孋	vmmp
妧	vmmu
娠	vmmv
牄	vmoir
彘	vmpop
妒	vmr
妍	vmt
牂	vmtq
妝	vmv
媷	vmvi
娙	vmvm
嫖	vmwf
媔	vmwl
嫣	vmyf
姃	vmym
娩	vnau
好	vnd
妳	vnf
妞	vng
媃	vnhd
奶	vnhs
妤	vnin
姼	vnin
姳	vnir
娗	vnkg
嫷	vnlb
婀	vnlr
彔	vnme
嫋	vnmm
彖	vnmo
姽	vnmu
婿	vnob
嬁	vnot
嬔	vnum
娹	vnyi
妠	vob
孇	voge
嫶	vogf
鶨	vohaf
妊	vohg
姈	voii
孅	voim
妗	voin
蠡	volii
妎	voll
姾	vomg
媮	vomn
嬐	vomo
姶	vomr
媮	vomv
姩	voq
媬	vord
媕	vort
嫵	votf
她	vpd
妼	vph
妁	vpi
妣	vpp
姁	vpr
媟	vptd
媰	vpuu
妦	vqj
媋	vqka
嫀	vqkd
婧	vqmb
嫊	vqmf
婊	vqmv
如	vr
娟	vrb
鴽	vrhaf
帤	vrlb
恕	vrp
挐	vrq
嬠	vrrd
嬋	vrrj
孍	vrrk
婽	vrse
絮	vrvif
娛	vrvk
娖	vryo
孎	vsei
鶭	vshaf
妱	vshr
娓	vshu
娵	vsje
嫕	vskp
姬	vsll
婦	vsmb
嬥	vsmg
嫪	vsmh
妮	vsp
媽	vsqf
娜	vsql
嫗	vsrr
姖	vss
嫟	vstr
妃	vsu
忌	vsup
嫫	vtak
婰	vtbc
媊	vtbn
媄	vtgk
嫸	vtgr
嬞	vthg
婼	vtkr
嫹	vtlc
嬿	vtlf
嫨	vtlo
姏	vtm
娸	vtmc
媒	vtmd
嬅	vtmj
媶	vtsj
姘	vtt
媾	vttb
嫸	vttr
嬨	vtvp
媌	vtw
嫌	vtxc
奾	vu
媏	vumb
媸	vumi
婩	vumj
孈	vuob
雝	vuog
媺	vuuk
奻	vv
災	vvf
姒	vvio
邕	vvrau
姦	vvv
巛	vvv
甾	vvw
巢	vvwd
媦	vwb
婐	vwd
娌	vwg
鶅	vwhaf
疀	vwjlo
婟	vwjr
姻	vwk
嬽	vwlk
嬛	vwlv
媼	vwot
嫘	vwvf
姆	vwyi
婥	vyaj
媜	vybc
嫡	vycb
姣	vyck
婌	vyfe
妵	vyg
妨	vyhs
嬂	vyia
妏	vyk
娮	vymr
嫭	vypd
婛	vyrf
婷	vyrn
孃	vyrv
嫙	vyso
嫜	vytj
婄	vytr
妶	vyvi
嬗	vywm
田	w
胃	wb
顒	wbmbc
愚	wbp
四	wc
囧	wcb
鷶	wchaf
畟	wche
果	wd
困	wd
褁	wdhv
顆	wdmbc
圍	wdmq
夥	wdnin
敤	wdye
畷	weee
疄	wfdq
黠	wfgr
黷	wfgwc
黲	wfiih
默	wfik
黓	wfip
黰	wfjbc
黦	wfjnu
黤	wfklu
黕	wflbu
黖	wfmvu
黫	wfmwg
黵	wfncr
黟	wfnin
黔	wfoin
黭	wfort
畔	wfq
圈	wfqu
黚	wftm
黮	wftmv
黜	wfuu
黝	wfvis
點	wfyr
黥	wfyrf
黯	wfyta
里	wg
畤	wgdi
黑	wgf
墨	wgfg
畦	wgg
圔	wgit
疇	wgni
野	wgnin
園	wgrv
圉	wgtj
囷	whd
畈	whe
略	wher
畽	whjg
畯	wice
鸀	wihaf
圃	wijb
畎	wik
歜	wino
國	wirm
斀	wiye
貫	wjbuc
毋	wjh
鸅	wjhaf
鷝	wjhaf
團	wjii
畹	wjnu
斁	wjok
固	wjr
因	wk
囿	wkb
畸	wkmr
欭	wkno
恩	wkp
男	wks
甲	wl
禺	wlbi
罝	wlbm
罦	wlbnd
買	wlbuc
罾	wlcwa
罧	wldd
罬	wleee
罣	wlgg
罫	wlggy
瞏	wlgrv
睪	wlgtj
鴨	wlhaf
罶	wlhhw
罛	wlhvo
罷	wlibp
羆	wlipf
罭	wlirm
置	wljbm
署	wljka
罟	wljr
罨	wlklu
目	wll
甽	wlll
罪	wllmy
圚	wlmc
罘	wlmf
罽	wlmfn
罡	wlmym
罞	wlnih
眾	wlooo
蜀	wlpli
罹	wlpog
罥	wlrb
罠	wlrvp
罻	wlsfi
罵	wlsqf
羃	wltab
羈	wltjf
羇	wltjr
羉	wlvff
羅	wlvfg
罺	wlvvd
罳	wlwp
罼	wlwtj
奰	wlwwk
罩	wlyaj
罜	wlyg
詈	wlymr
罰	wlyri
罰	wlyrn
罿	wlytg
畀	wml
圄	wmmr
町	wmn
圂	wmso
畏	wmv
囝	wnd
墅	wng
囚	wo
畛	wohh
囹	woii
畋	wok
界	woll
圇	womb
慁	wop
囮	wop
思	wp
囫	wphh
腮	wpmbc
畇	wpmm
毗	wpp
毘	wpp
囤	wpu
圊	wqmb
回	wr
圓	wrbc
圖	wrjw
圖	wryw
嬲	wsvws
異	wtc
畢	wtj
圌	wumb
囡	wv
圞	wvfd
累	wvif
翾	wvsmm
鸓	wwhaf
圛	wwlj
圜	wwlv
畾	www
櫐	wwwd
纍	wwwf
壘	wwwg
疊	wwwm
礨	wwwr
罍	wwwu
壨	wwwwg
囥	wyhn
母	wyi
圁	wymr
甿	wyv
曰	xa
昍	xaa
暈	xabjj
炚	xaf
顥	xafmb
晑	xahbr
旰	xamj
冕	xanau
欥	xano
昒	xaphh
煦	xarf
旵	xau
昢	xauu
鷃	xavha
旼	xayk
晾	xayrf
郥	xbcnl
縢	xbfqf
冗	xbhn
膬	xbhuu
鶪	xbkha
肛	xbm
刞	xbmln
塚	xbmso
脕	xbnau
冊	xbt
覞	xbubu
瞗	xbuha
瞚	xbujm
睢	xbuog
臅	xbwli
銩	xchgi
鳻	xchha
釽	xchlo
釩	xchni
鎞	xchwp
銊	xcihm
釴	xcip
鐮	xcitc
鏔	xcjmc
鎵	xcjmo
釱	xck
鈦	xcki
釚	xckn
銔	xcmfj
銫	xcnau
弚	xcnl
鐊	xcnlh
鋡	xcoir
鉓	xcolb
鈊	xcp
鉤	xcpi
弅	xcsht
鑆	xctgi
鐹	xcybb
銃	xcyiu
鋅	xcytj
柦	xdam
棗	xdbdb
檒	xddhn
榃	xddw
板	xdhe
杋	xdhni
椼	xdhon
橁	xdhpa
櫠	xdine
杕	xdk
朹	xdkn
檶	xdksr
柫	xdlln
杠	xdm
枑	xdmvm
槱	xdmwf
杍	xdnd
楺	xdnhd
杼	xdnin
梒	xdoir
杺	xdp
栺	xdpa
构	xdpi
框	xdsmg
梱	xdwd
檛	xdybb
梓	xdytj
檤	xdytu
榱	xdywv
沓	xea
灝	xeafc
闊	xeanr
滘	xebcr
濉	xebug
汃	xec
沝	xee
塣	xegg
盪	xehbt
灚	xehbu
硰	xehmr
渢	xehni
漇	xehoo
淚	xehsk
瀩	xehuc
濂	xeitc
漥	xejcg
浨	xejd
濣	xejjj
演	xejmc
汯	xeki
浠	xekkb
氿	xekn
灗	xelim
沜	xelll
灞	xembb
澪	xembi
灑	xemcw
鴻	xemhf
沍	xemvm
湹	xemwg
泓	xeni
沀	xenin
瀹	xeomb
渝	xeomn
涻	xeomr
柒	xepd
洭	xesmg
汫	xett
渵	xetw
鍌	xeuc
涃	xewd
濄	xeybb
湤	xeysd
滖	xeywv
敞	xfbok
炯	xfbr
炑	xfd
熒	xffbf
爃	xfffd
顃	xffmb
焓	xfoir
熤	xfsmt
烡	xftc
熵	xfycb
愨	xgep
鷇	xgfhn
墝	xgggu
劫	xgiks
螫	xgklm
堧	xgmbb
彀	xgnhn
堩	xgpmm
欯	xgrno
嘉	xgrtr
垶	xgytj
丿	xh
馫	xhaha
癿	xhau
爂	xhbf
鷮	xhbha
顅	xhbmb
礐	xhbmr
嶨	xhbu
篹	xhbuu
劗	xhcln
鄮	xhcnl
鷍	xhdha
種	xhdl
剁	xhdln
秞	xhdlw
鄡	xhdnl
夊	xhe
釆	xhfd
簃	xhhdn
簁	xhhoo
篦	xhhwp
簙	xhjii
鸄	xhkha
懲	xhkp
啟	xhkr
嶴	xhku
笰	xhlln
籈	xhmgn
鷎	xhmha
邸	xhmnl
梨	xhnd
彳	xho
鴩	xhoha
瓝	xhopi
黴	xhouf
筍	xhpa
鴰	xhrha
劄	xhrln
郈	xhrnl
勹	xhs
籊	xhsmg
笸	xhsr
鶞	xhuha
兟	xhuhg
郋	xhunl
憩	xhup
覣	xhvbu
鶹	xhwha
箎	xhypu
笘	xhyr
、	xi
宀	xib
鷛	xibha
鄘	xibnl
鄬	xifnl
慼	xifp
蠯	xihji
剆	xiiln
庋	xije
義	xik
亠	xim
栥	xiod
庀	xip
麃	xipf
鳶	xipha
庇	xipp
怠	xirp
弁	xit
鷏	xjcha
穵	xjcn
宋	xjd
廾	xjj
轛	xjjtg
軿	xjjyj
鶷	xjrha
剋	xjuln
鴳	xjvha
寱	xjvmd
寣	xjvmr
乂	xk
冇	xkb
郁	xkbnl
瘌	xkdln
疢	xkf
猏	xkhhs
癓	xkhok
痻	xkhpa
痲	xkjcc
瘏	xkjka
痏	xkkb
鸑	xkkha
疘	xkm
痾	xkmnr
夷	xkn
旮	xkna
厹	xkni
痑	xknin
鴐	xkrha
羍	xktq
尢	xku
幊	xlbmb
蚓	xlijm
蝆	xlitq
衶	xll
冖	xln
冑	xlwb
裍	xlwd
鸍	xmbha
貢	xmbuc
覝	xmfbu
顠	xmfmb
玥	xmgb
鳿	xmgha
玊	xmgi
臹	xmgih
鄄	xmgnl
歅	xmgno
琀	xmgoi
玫	xmgok
珌	xmgph
玭	xmgpp
臻	xmgqk
珫	xmgyi
鷣	xmjha
憨	xmkp
鵛	xmmha
鴷	xmnha
殥	xmnjm
恐	xmnp
剢	xmoln
泵	xmre
酃	xmrnl
歌	xmrno
敔	xmrok
礣	xmrtw
郖	xmtnl
堙	xmwg
亅	xn
弝	xnau
墮	xnbg
觔	xnbks
氶	xne
鱴	xnftw
弘	xni
弔	xnl
陝	xnlko
檃	xnmd
久	xno
仴	xob
烋	xodf
汆	xoe
尒	xof
鷡	xofha
隹	xog
栠	xogd
隻	xoge
鵀	xogha
犨	xoghq
恁	xogp
佶	xogr
俍	xoiav
侂	xoihp
怤	xoip
午	xoj
鴙	xokha
侇	xokn
佑	xokr
絛	xolof
倏	xolok
仝	xom
嵞	xomdu
侲	xommv
气	xomn
伃	xonin
伄	xonl
倠	xoog
伈	xop
貸	xopbu
柋	xopd
伅	xopu
鶬	xorha
頷	xormb
僛	xotco
仚	xou
僆	xoyjj
偯	xoyrv
旨	xpa
熲	xpfmb
曶	xpha
悷	xphsk
勺	xpi
勼	xpkn
愩	xpmbc
匉	xpmfj
愊	xpmrw
憟	xpmwd
恉	xppa
忉	xpsh
忷	xpuk
慛	xpuog
悃	xpwd
洯	xqhe
扷	xqhk
抓	xqhlo
恝	xqhp
揙	xqhsb
捩	xqhsk
搣	xqihf
鄻	xqjnl
焎	xqlf
拸	xqnin
捨	xqomr
擢	xqsmg
摒	xqsyj
捰	xqwd
撾	xqybb
摙	xqyjj
邑	xrau
唄	xrbuc
叭	xrc
劋	xrdln
唳	xrhsk
嚓	xrjbf
戢	xrji
呔	xrki
叻	xrks
唒	xrmcw
啀	xrmgg
蹝	xrmho
唔	xrmmr
唅	xroir
啥	xromr
咰	xrpa
獸	xrrik
喿	xrrrd
鴞	xrsha
咡	xrsj
喔	xrsmg
囆	xrtwi
喍	xrypd
臀	xseb
贀	xsebu
壂	xseg
嫛	xsev
繄	xsevi
騂	xsfyt
鳭	xshha
戮	xshi
屧	xshod
屐	xshoe
慰	xsip
憵	xsjp
屝	xslmy
翋	xsmyt
鶋	xsrha
邵	xsrnl
群	xsrtq
已	xsu
妀	xsuv
槊	xtbd
蒯	xtbln
顢	xtbmb
菳	xtc
鷬	xtcha
歉	xtcno
惎	xtcp
莌	xtcru
鷋	xtdha
萿	xtehr
藫	xtemj
蓺	xtggi
羑	xtgno
戁	xtgp
蘤	xthaf
菞	xthdh
藒	xthdv
藢	xthok
蘅	xthon
蓗	xthoo
菺	xthsb
蓖	xthwp
蒧	xtihr
芅	xtip
萓	xtjbm
苧	xtjmn
莞	xtjmu
鄿	xtjnl
鞙	xtjrb
鴱	xtkha
艽	xtkn
鄚	xtknl
鷰	xtlpf
蕶	xtmbi
莤	xtmcw
芋	xtmd
薽	xtmgn
菫	xtmlm
鄞	xtmnl
薞	xtmnv
蓩	xtnhs
茤	xtnin
茠	xtod
茌	xtog
蘥	xtomb
芞	xtomn
荅	xtomr
莝	xtoog
芶	xtpi
羋	xtq
鄀	xtrnl
藯	xtsip
苨	xtsp
并	xtt
蘳	xttcg
鵧	xttha
荊	xttln
艵	xttna
刱	xttsh
孳	xtvid
薅	xtvmi
曲	xtw
茵	xtwk
薎	xtwli
甍	xtwln
藣	xtwlp
薖	xtybb
藗	xtydo
蕸	xtyre
藹	xtyrv
蒟	xtytr
剻	xubln
峰	xuhej
峈	xuher
峸	xuihs
峖	xujv
嶚	xukcf
峏	xumbl
岋	xunhe
峞	xunmu
雟	xuogb
岭	xuoii
岒	xuoin
峆	xuomr
艸	xuu
峷	xuytj
嫦	xvfbb
鷥	xvfha
縰	xvfho
綟	xvfhs
紁	xvfik
縯	xvfjm
絻	xvfna
您	xvfp
姅	xvfq
厶	xvi
槳	xvid
婝	xvjmo
姼	xvnin
巛	xvvv
困	xwd
鷝	xwjha
囮	xwop
毘	xwpp
鷐	xxavh
囗	xxbm
膗	xxbuo
懘	xxebp
瀜	xxemb
渥	xxesm
皞	xxhah
鷽	xxhbh
笻	xxhmn
鰴	xxhou
鵅	xxhrh
鵚	xxhuh
忒	xxipp
郩	xxkbn
鯈	xxolo
鵨	xxorh
屳	xxou
顈	xxpfm
婜	xxsev
鵘	xxsrh
莰	xxtgn
蓏	xxtho
卌	xxtt
藅	xxtwl
蔎	xxtyr
屾	xxuu
鵳	xxxhb
鴭	xxxhr
麀	xxxip
鴯	xxxmb
仜	xxxom
蘮	xxxtw
鸆	xxxya
褒	xxyhd
顪	xxyhm
鳼	xxykh
甗	xybmv
欳	xybno
迥	xybr
鶐	xycha
奕	xyck
戇	xycp
敹	xydok
褒	xyhdv
顏	xyhmb
鷟	xykha
憝	xykp
皻	xymdh
逜	xymmr
忐	xymp
劇	xyoln
迆	xypd
鸗	xypha
龒	xypmm
礱	xypmr
讋	xypym
詗	xyrbr
毫	xyrbu
詣	xyrpa
囈	xyrtg
乩	xyru
謪	xyryc
謯	xyryp
鴗	xytha
膂	xyvb
邋	xyvvv
褱	xywlv
齋	xyxf
卜	y
桌	yad
韹	yahag
韸	yahej
戠	yai
卓	yaj
逿	yamh
歆	yano
暹	yaog
遏	yapv
韻	yarbc
韶	yashr
遢	yasm
韺	yatlk
頀	yatoe
退	yav
髜	ybaht
過	ybbr
週	ybgr
鶙	ybhaf
望	ybhg
毃	ybhne
邈	ybhu
獻	ybik
運	ybjj
帝	yblb
睿	ybmcu
遯	ybmo
迵	ybmr
甋	ybmvn
甗	ybmvn
鄗	ybnl
歊	ybno
欳	ybno
離	ybog
敵	ybok
遙	ybou
週	ybqr
啻	ybr
迥	ybr
貞	ybuc
敲	ybye
旁	ybyhs
龍	ybysp
六	yc
商	ycbr
鶐	ychaf
顰	ychwj
交	yck
奕	yck
帟	yclb
戇	ycp
戇	ycp
兗	ycrhu
袞	ycrhv
弈	yct
巒	ycu
親	ydbuu
鶉	ydhaf
虨	ydhhh
新	ydhml
孰	ydkni
速	ydl
遫	ydlk
違	ydmq
郭	ydnl
歑	ydno
雜	ydog
敦	ydok
敹	ydok
嚲	ydrrj
攴	ye
督	yebu
錖	yec
粲	yefd
逤	yefh
壑	yeg
韰	yelsm
餐	yeoiv
惄	yep
裻	yeyhv
逍	yfb
迷	yfd
遴	yfdq
叔	yfe
鶁	yfhaf
就	yfiku
勍	yfks
敊	yfye
主	yg
逵	ygcg
遶	yggu
殶	yghne
氃	yghqu
褻	ygiv
虧	ygmms
迼	ygr
遠	ygrv
遨	ygsk
達	ygtq
广	yh
迫	yha
鳪	yhaf
遑	yhag
亹	yhbm
透	yhds
逶	yhdv
褒	yhdv
褒	yhdv
返	yhe
逢	yhej
逄	yheq
造	yhgr
彥	yhhhh
產	yhhqm
遛	yhhw
褢	yhiv
适	yhjr
遁	yhju
劌	yhln
頻	yhmbc
顪	yhmbc
顏	yhmbc
近	yhml
遾	yhmo
逅	yhmr
亢	yhn
迭	yhqo
造	yhqr
追	yhrr
方	yhs
遍	yhsb
邀	yhsk
翽	yhsmm
邊	yhus
衣	yhv
迎	yhvl
邍	yhwe
廉	yhxc
裒	yhxv
遞	yhyu
育	yib
逡	yice
述	yid
熟	yif
玅	yifh
塾	yig
充	yihu
斔	yihxo
逋	yijb
述	yijc
逑	yije
迖	yik
玈	yiohv
率	yioj
迨	yir
袬	yirv
棄	yitd
遮	yitf
玆	yiyvi
斗	yj
邃	yjco
辣	yjdl
鵫	yjhaf
贛	yjhec
彰	yjhhh
瓣	yjhoj
竷	yjhqe
辨	yjilj
辦	yjksj
鄣	yjnl
逭	yjrr
辮	yjvfj
連	yjwj
并	yjyj
瓶	yjyjn
辯	yjyrj
文	yk
斕	ykanw
迶	ykb
遼	ykcf
鵁	ykhaf
鳼	ykhaf
鷟	ykhaf
斖	ykhbm
逖	ykhf
逛	ykhg
彣	ykhhh
斒	ykhsb
效	ykks
蠃	yklmi
頝	ykmbc
彥	ykmhh
產	ykmhm
斌	ykmpm
郊	yknl
效	ykok
忞	ykp
憝	ykp
遰	ykpb
撉	ykq
吝	ykr
迦	yksr
紊	ykvif
齾	ykymu
市	ylb
逮	yle
衷	ylhv
止	ylm
遺	ylmc
步	ylmh
逃	ylmo
遣	ylmr
亦	ylnc
迪	ylw
上	ym
肯	ymb
贇	ymbuc
覷	ymbuu
迺	ymcw
迂	ymd
皽	ymdhe
皻	ymdhe
邇	ymfb
迋	ymg
歭	ymgdi
鸇	ymhaf
氈	ymhqu
歲	ymihh
歧	ymje
迗	ymk
勯	ymks
剷	ymln
顫	ymmbc
邐	ymmp
言	ymmr
逜	ymmr
迾	ymnn
歔	ymno
此	ymp
忐	ymp
雌	ympog
逗	ymrt
逼	ymrw
逐	ymso
齒	ymuoo
迓	ymvh
逕	ymvm
遷	ymwu
卡	ymy
逸	ynai
邂	ynbq
贏	ynbuc
遜	yndf
鸁	ynhaf
遹	ynhb
袤	ynhv
通	ynib
迻	ynin
袲	yniv
迅	ynj
蠃	ynlmi
頏	ynmbc
邟	ynnl
邆	ynot
羸	yntq
嬴	ynv
臝	ynwd
褒	yodv
進	yog
毅	yohne
迕	yoj
劾	yoks
刻	yoln
劇	yoln
頦	yombc
途	yomd
逾	yomn
逾	yomv
迄	yon
夜	yonk
欬	yono
卒	yooj
迤	yopd
迮	yos
虍	yp
迿	ypa
眥	ypbu
貲	ypbuc
鈭	ypc
柴	ypd
迆	ypd
壟	ypg
鷾	yphaf
鸗	yphaf
處	yphen
虖	yphfd
虎	yphn
虎	yphu
勴	ypks
蠪	yplmi
龑	ypmk
些	ypmm
祡	ypmmf
龒	ypmmf
砦	ypmr
礱	ypmr
鬳	ypmrb
豦	ypmso
觜	ypnbg
鮆	ypnwf
胔	ypobo
飺	ypoiv
虔	ypok
虙	ypph
呰	ypr
虞	yprmk
虞	yprvk
聾	ypsj
虐	ypsm
迣	ypt
龔	yptc
虛	yptm
虡	yptmc
迍	ypu
袌	ypuv
紫	ypvif
膚	ypwb
盧	ypwbt
虜	ypwks
歶	ypwlb
慮	ypwp
龘	ypybp
襲	ypyhv
虔	ypyk
訾	ypymr
讋	ypymr
逝	yqhl
占	yr
諟	yramo
譋	yranb
讕	yranw
謁	yrapv
裛	yrav
謾	yrawe
膏	yrbb
調	yrbgr
諂	yrbhx
諢	yrbjj
詛	yrbm
諼	yrbme
詷	yrbmr
亭	yrbn
豪	yrbo
謠	yrbou
亳	yrbp
調	yrbqr
高	yrbr
詗	yrbr
諍	yrbsd
亮	yrbu
毫	yrbu
覘	yrbuu
謑	yrbvk
訟	yrci
諡	yrcmt
說	yrcru
諃	yrdd
詖	yrdhe
討	yrdi
訣	yrdk
諱	yrdmq
誺	yrdoo
諫	yrdwf
誻	yrea
京	yrf
誚	yrfb
讜	yrfbf
談	yrff
訬	yrfh
詊	yrfq
讟	yrgcr
詩	yrgdi
詿	yrgg
譊	yrggu
譸	yrgni
誌	yrgp
詰	yrgr
譆	yrgrr
讀	yrgwc
諻	yrhag
謻	yrhdn
誘	yrhds
諉	yrhdv
譒	yrhdw
詻	yrher
逞	yrhg
譭	yrhge
誥	yrhgr
詵	yrhgu
謝	yrhhi
誅	yrhjd
諈	yrhjm
話	yrhjr
訞	yrhk
譑	yrhkb
訢	yrhml
詬	yrhmr
訴	yrhmy
設	yrhne
諷	yrhni
譗	yrhor
託	yrhp
諙	yrhpa
詆	yrhpm
詄	yrhqo
諞	yrhsb
謆	yrhsm
讚	yrhuc
哀	yrhv
諀	yrhwj
謥	yrhwp
謏	yrhxe
諛	yrhxo
誽	yrhxu
謕	yrhyu
誏	yriav
諴	yrihr
誠	yrihs
諓	yrii
誧	yrijb
訹	yrijc
詙	yrikk
訧	yriku
詶	yrill
詠	yrine
誒	yriok
諮	yrior
試	yripm
貽	yrir
誡	yrit
譧	yritc
謶	yritf
計	yrj
謓	yrjbc
誖	yrjbd
諵	yrjbj
誼	yrjbm
詫	yrjhp
讅	yrjhw
譓	yrjip
諸	yrjka
諠	yrjmm
詑	yrjp
詁	yrjr
詴	yrkb
詼	yrkf
誑	yrkhg
譇	yrkja
誇	yrkms
訓	yrlll
謱	yrllv
誂	yrlmo
誹	yrlmy
剖	yrln
訌	yrm
謣	yrmbs
訏	yrmd
評	yrmfj
逞	yrmg
謜	yrmhf
讈	yrmhm
訐	yrmj
譀	yrmjk
語	yrmmr
誫	yrmmv
訂	yrmn
訶	yrmnr
誣	yrmoo
諮	yrmor
諨	yrmrw
諑	yrmso
譖	yrmua
訝	yrmvh
誙	yrmvm
瓿	yrmvn
謤	yrmwf
諲	yrmwg
譚	yrmwj
証	yrmym
讂	yrnbe
譫	yrncr
享	yrnd
烹	yrnf
譎	yrnhb
諂	yrnhx
誦	yrnib
誃	yrnin
詺	yrnir
訊	yrnj
誕	yrnkm
部	yrnl
讔	yrnlp
詭	yrnmu
亨	yrnn
諝	yrnob
證	yrnot
謋	yrnqd
讒	yrnri
誸	yrnyi
訥	yrob
誰	yrog
謢	yroge
譙	yrogf
診	yrohh
詅	yroii
讖	yroim
諗	yroip
謒	yroir
許	yroj
敨	yrok
論	yromb
詮	yromg
諭	yromn
譣	yromo
諭	yromv
訖	yron
訛	yrop
詐	yros
譕	yrotf
誨	yrowy
詢	yrpa
詣	yrpa
訑	yrpd
謐	yrpht
譺	yrpko
諧	yrppa
詍	yrpt
諜	yrptd
訰	yrpu
謅	yrpuu
誄	yrqd
譿	yrqjp
請	yrqmb
謮	yrqmc
諘	yrqmv
譟	yrrrd
譂	yrrrj
諤	yrrrs
遻	yrrs
諿	yrrsj
遻	yrru
譔	yrruc
襄	yrrv
誤	yrrvk
譝	yrrxu
遐	yrse
訒	yrshi
詔	yrshr
譅	yrsim
認	yrsip
諏	yrsje
讘	yrsjj
謵	yrsma
誆	yrsmg
謬	yrsmh
詡	yrsmm
詞	yrsmr
謳	yrsrr
詎	yrss
記	yrsu
誋	yrsup
謘	yrsyj
謨	yrtak
譪	yrtav
譾	yrtbm
譜	yrtca
謚	yrtct
議	yrtgi
囈	yrtgi
諾	yrtkr
讌	yrtlf
謹	yrtlm
詌	yrtm
譜	yrtma
諆	yrtmc
謀	yrtmd
譁	yrtmj
諶	yrtmv
護	yrtoe
詳	yrtq
讙	yrtrg
誁	yrtt
講	yrttb
譐	yrtwi
譨	yrtwv
謙	yrtxc
謊	yrtyu
訕	yru
乩	yru
選	yruc
諯	yrumb
詘	yruu
譏	yrvii
詏	yrvis
謂	yrwb
謖	yrwce
課	yrwd
譯	yrwlj
諰	yrwp
讄	yrwww
訃	yry
諦	yrybb
讞	yrybk
謗	yrybs
謫	yrycb
謪	yrycb
詨	yryck
譈	yrydk
敁	yrye
謎	yryfd
諔	yryfe
註	yryg
諺	yryhh
訪	yryhs
識	yryia
謰	yryjj
諺	yrykh
譴	yrylr
訿	yrymp
誶	yryoj
謼	yrypd
謔	yrypm
謯	yrypm
諕	yrypu
詀	yryr
謞	yryrb
諄	yryrd
諒	yryrf
譹	yryro
讓	yryrv
諳	yryta
謧	yryub
該	yryvo
譠	yrywm
謫	yryyb
迉	ys
遲	yseq
褭	ysfv
迢	yshr
与	ysm
瓬	ysmvn
邡	ysnl
旃	ysoby
旓	ysofb
旟	ysohc
旂	ysohl
旌	ysohm
斻	ysohn
旄	ysohu
旅	ysohv
旛	ysohw
旆	ysojb
放	ysok
旖	ysokr
旐	ysolo
旚	ysomf
斿	ysond
旋	ysono
旝	ysooa
旍	ysooi
族	ysook
施	ysopd
旎	ysosp
旗	ysotc
於	ysoy
旒	ysoyu
迡	ysp
避	ysrj
旞	ysyoo
立	yt
音	yta
竟	ytahu
章	ytaj
意	ytap
竭	ytapv
竫	ytbsd
遒	ytcw
竦	ytdl
鸕	ythaf
鴗	ythaf
颯	ythni
道	ythu
戲	yti
竣	ytice
辛	ytj
竤	ytjki
佇	ytjmn
送	ytk
竑	ytki
逽	ytkr
顱	ytmbc
遳	ytog
遂	ytpo
竘	ytpr
靖	ytqmb
翊	ytsmm
竮	ytstt
迸	ytt
遘	yttb
逆	ytu
溯	ytub
端	ytumb
妾	ytv
遭	ytwa
邁	ytwb
童	ytwg
遵	ytwi
站	ytyr
辿	yu
齦	yuav
齟	yubm
贙	yubuc
覤	yubuu
導	yudi
叡	yue
鷲	yuhaf
彪	yuhhh
齲	yuhlb
齗	yuhml
齯	yuhxu
虥	yuii
齝	yuir
齻	yujbc
离	yukb
齮	yukmr
齥	yulwp
遄	yumb
齬	yummr
齖	yumvh
齡	yuoii
虪	yuolf
齘	yuoll
齕	yuon
齔	yup
齣	yupr
齙	yupru
齛	yupt
齺	yupuu
齞	yurc
齶	yurrs
齪	yuryo
齠	yushr
齱	yusje
齷	yusmg
齰	yuta
齸	yutct
甝	yutm
齫	yuwd
齵	yuwlb
齴	yuyhh
齜	yuymp
虤	yuypu
競	yuytu
亡	yv
肓	yvb
膂	yvb
裔	yvbcr
牽	yvbq
盲	yvbu
杗	yvd
壅	yvgg
甕	yvgn
罋	yvgu
饔	yvgv
衁	yvhbt
雍	yvhg
巟	yvhlu
亥	yvho
瓤	yvhvo
玄	yvi
畜	yviw
勷	yvks
逯	yvne
邙	yvnl
賌	yvoc
忘	yvp
氓	yvrvp
妄	yvv
巡	yvvv
邋	yvvv
裹	ywdv
裏	ywgv
鹹	ywihr
鹵	ywii
遇	ywlb
遝	ywle
邏	ywlg
還	ywlv
褱	ywlv
衰	ywmv
鄐	ywnl
畝	ywno
鹼	ywomo
迴	ywr
稟	ywrd
稟	ywrf
亶	ywrm
卣	yws
鹺	ywtqm
齊	yx
齍	yxbt
齎	yxbuc
齌	yxf
齋	yxf
劑	yxln
齏	yxlsm
卞	yy
逴	yyaj
遉	yybc
適	yycb
迒	yyhn
跡	yylc
這	yymr
遽	yypo
迠	yyr
遊	yysd
遧	yytj
邅	yywm
逌	yyws
「	yyyaa
」	yyyab
『	yyyac
』	yyyad
〈	yyyae
〉	yyyaf
《	yyyag
》	yyyah
【	yyyam
】	yyyan
→	yyyas
←	yyyat
↓	yyyau
↗	yyyav
↘	yyyaw
↖	yyyax
↙	yyyay
△	yyyba
▲	yyybb
▽	yyybc
▼	yyybd
◇	yyybe
◆	yyybf
□	yyybg
■	yyybh
☆	yyybi
★	yyybj
○	yyybk
●	yyybl
⊙	yyybm
◎	yyybn
×	yyybo
※	yyybp
♂	yyybq
♀	yyybr
§	yyybs
’	yyybt
‘	yyybu
”	yyybv
“	yyybw
￥	yyybx
˙	yyyby
⊕	yyyca
℅	yyycb
￠	yyycc
￡	yyycd
℃	yyyce
℉	yyycf
°	yyycg
…	yyych
÷	yyyda
±	yyydb
≦	yyydc
≧	yyydd
≠	yyyde
√	yyydf
∞	yyydh
≒	yyydi
≡	yyydj
∪	yyydl
∩	yyydm
∠	yyydn
⊿	yyydo
∫	yyydp
∮	yyydq
∵	yyydr
∴	yyyds
Ⅱ	yyyga
Ⅲ	yyygb
Ⅳ	yyygc
Ⅵ	yyygd
Ⅷ	yyygf
Ⅸ	yyygg
〡	yyygh
〢	yyygi
〣	yyygj
〥	yyygk
〦	yyygl
〧	yyygm
〨	yyygn
①	yyyha
②	yyyhb
③	yyyhc
④	yyyhd
⑤	yyyhe
⑥	yyyhf
⑦	yyyhg
⑧	yyyhh
⑨	yyyhi
⑩	yyyhj
⑴	yyyhk
⑵	yyyhl
⑶	yyyhm
⑷	yyyhn
⑸	yyyho
⑹	yyyhp
⑺	yyyhq
⑻	yyyhr
⑼	yyyhs
⑽	yyyht
ㄅ	yyyxa
ㄆ	yyyxb
ㄇ	yyyxc
ㄈ	yyyxd
ㄉ	yyyxe
ㄊ	yyyxf
ㄋ	yyyxg
ㄌ	yyyxh
ㄍ	yyyxi
ㄎ	yyyxj
ㄏ	yyyxk
ㄐ	yyyxl
ㄑ	yyyxm
ㄒ	yyyxn
ㄓ	yyyxo
ㄔ	yyyxp
ㄕ	yyyxq
ㄖ	yyyxr
ㄗ	yyyxs
ㄘ	yyyxt
ㄙ	yyyxu
ㄧ	yyyxv
ㄨ	yyyxw
ㄩ	yyyxx
ㄚ	yyyxy
ㄛ	yyyya
ㄜ	yyyyb
ㄝ	yyyyc
ㄞ	yyyyd
ㄟ	yyyye
ㄠ	yyyyf
ㄡ	yyyyg
ㄢ	yyyyh
ㄣ	yyyyi
ㄤ	yyyyj
ㄥ	yyyyk
ㄦ	yyyyl
ˊ	yyyym
ˇ	yyyyn
ˋ	yyyyo
	zzaaa
	zzaab
	zzaac
	zzaad
	zzaae
	zzaaf
	zzaag
	zzaah
	zzaai
	zzaaj
	zzaak
	zzaal
	zzaam
	zzaan
	zzaao
	zzaap
	zzaaq
	zzaar
	zzaas
	zzaat
	zzaau
	zzaav
	zzaaw
	zzaax
	zzaay
	zzaba
	zzabb
	zzabc
	zzabd
	zzabe
	zzabf
	zzabg
	zzabh
	zzabi
	zzabj
	zzabk
	zzabl
	zzabm
	zzabn
	zzabo
	zzabp
	zzabq
	zzabr
	zzabs
	zzabt
	zzabu
	zzabv
	zzabw
	zzabx
	zzaca
	zzacb
	zzacc
	zzacd
	zzace
	zzacf
	zzacg
	zzach
	zzaci
	zzacj
	zzack
	zzacl
	zzacm
	zzacn
	zzaco
	zzacp
	zzacq
	zzacr
	zzacs
	zzact
	zzacu
	zzacv
	zzacw
	zzacx
	zzacy
	zzada
	zzadb
	zzadc
	zzadd
	zzade
	zzadf
	zzadg
	zzadh
	zzadi
	zzadj
	zzadk
	zzadl
	zzadm
	zzadn
	zzado
	zzadp
	zzadq
	zzadr
	zzads
	zzadt
	zzadu
	zzadv
	zzadw
	zzadx
	zzady
	zzafa
	zzafb
	zzafc
	zzafd
	zzafe
	zzaff
	zzafg
	zzafh
	zzafi
	zzafj
	zzafk
	zzafl
	zzafm
	zzafn
	zzafo
	zzafp
	zzafq
	zzafr
	zzafs
	zzaft
	zzafu
	zzafv
	zzafw
	zzafx
	zzafy
	zzaga
	zzagb
	zzagc
	zzagd
	zzage
	zzagf
	zzagg
